filing_number,time_filed,form_type,skeda_lines,skedb_lines,skede_lines,other_lines,total_lines
968204,10/23 11:59 PM,F3N,1,5,0,0,6
968203,10/23 11:59 PM,F3N,1,0,0,0,1
968202,10/23 11:59 PM,F3N,20,15,0,0,35
968201,10/23 11:57 PM,F24N,0,0,2,0,2
968200,10/23 11:56 PM,F3XN,27,10,0,17,54
968199,10/23 11:56 PM,F3XN,61,25,0,1,87
968198,10/23 11:55 PM,F3XN,91,254,0,20,365
968197,10/23 11:53 PM,F6N,5,0,0,0,5
968196,10/23 11:53 PM,F6N,1,0,0,0,1
968195,10/23 11:51 PM,F3XN,148,62,0,114,324
968194,10/23 11:49 PM,F3N,136,89,0,1,226
968193,10/23 11:49 PM,F3N,53,28,0,3,84
968192,10/23 11:48 PM,F3XN,91,130,0,31,252
968191,10/23 11:48 PM,F3N,149,33,0,3,185
968190,10/23 11:48 PM,F3N,5,28,0,1,34
968189,10/23 11:48 PM,F3N,145,29,0,0,174
968188,10/23 11:48 PM,F3XN,12,20,0,52,84
968187,10/23 11:47 PM,F6N,1,0,0,0,1
968186,10/23 11:47 PM,F3XN,96,7,0,117,220
968185,10/23 11:46 PM,F3A,2813,266,0,4,3083
968184,10/23 11:46 PM,F6N,3,0,0,0,3
968183,10/23 11:45 PM,F3XN,0,0,0,0,0
968182,10/23 11:44 PM,F3XN,1,4,0,5,10
968181,10/23 11:44 PM,F3N,9,3,0,0,12
968180,10/23 11:43 PM,F3N,1379,111,0,0,1490
968179,10/23 11:43 PM,F3N,74,13,0,15,102
968178,10/23 11:42 PM,F3N,5,11,0,2,18
968177,10/23 11:42 PM,F3XN,0,0,0,0,0
968176,10/23 11:42 PM,F3N,35,12,0,0,47
968175,10/23 11:42 PM,F6N,9,0,0,0,9
968174,10/23 11:41 PM,F3XN,0,3,0,0,3
968173,10/23 11:40 PM,F3XA,56,137,0,35,228
968172,10/23 11:40 PM,F6N,3,0,0,0,3
968171,10/23 11:40 PM,F3N,11,2,0,5,18
968170,10/23 11:39 PM,F3N,43,9,0,1,53
968169,10/23 11:39 PM,F3XN,0,0,0,3,3
968168,10/23 11:36 PM,F3N,44,26,0,11,81
968167,10/23 11:35 PM,F3N,48,120,0,0,168
968166,10/23 11:34 PM,F3XN,2,7,0,0,9
968165,10/23 11:33 PM,F3XN,0,0,0,0,0
968164,10/23 11:33 PM,F6N,2,0,0,0,2
968163,10/23 11:32 PM,F6N,3,0,0,0,3
968162,10/23 11:32 PM,F3XN,0,4,0,0,4
968161,10/23 11:31 PM,F3XN,49,30,0,159,238
968160,10/23 11:30 PM,F3N,168,27,0,0,195
968159,10/23 11:29 PM,F3N,184,65,0,10,259
968158,10/23 11:28 PM,F3N,83,55,0,0,138
968157,10/23 11:27 PM,F3N,12,14,0,3,29
968156,10/23 11:27 PM,F3N,1428,102,0,3,1533
968155,10/23 11:27 PM,F3N,330,106,0,0,436
968154,10/23 11:26 PM,F3XN,8,204,0,3,215
968153,10/23 11:25 PM,F3A,70,42,0,3,115
968152,10/23 11:24 PM,F3N,139,23,0,9,171
968151,10/23 11:22 PM,F3XN,16,9,0,4,29
968150,10/23 11:21 PM,F3XN,19,14,0,20,53
968149,10/23 11:19 PM,F3N,231,65,0,0,296
968148,10/23 11:18 PM,F3N,119,31,0,12,162
968147,10/23 11:18 PM,F3N,13,17,0,5,35
968146,10/23 11:18 PM,F3XN,2,2,0,0,4
968145,10/23 11:17 PM,F6N,2,0,0,0,2
968144,10/23 11:15 PM,F3N,92,29,0,0,121
968143,10/23 11:13 PM,F3N,31,32,0,3,66
968142,10/23 11:12 PM,F3N,24,25,0,46,95
968141,10/23 11:11 PM,F3N,2,5,0,8,15
968140,10/23 11:11 PM,F3XN,20,60,0,0,80
968139,10/23 11:10 PM,F3XN,0,0,0,0,0
968138,10/23 11:10 PM,F3XN,18,20,0,12,50
968137,10/23 11:09 PM,F3XN,34,138,0,123,295
968136,10/23 11:09 PM,F3XN,2,8,0,11,21
968135,10/23 11:08 PM,F3N,3,2,0,3,8
968134,10/23 11:07 PM,F3N,3,7,0,0,10
968133,10/23 11:07 PM,F24N,0,0,302,0,302
968132,10/23 11:04 PM,F3N,4,29,0,2,35
968131,10/23 11:04 PM,F3LN,0,0,0,1,1
968130,10/23 11:04 PM,F3XN,1,30,0,0,31
968129,10/23 11:03 PM,F3N,35,27,0,0,62
968128,10/23 11:01 PM,F3N,0,3,0,0,3
968127,10/23 10:59 PM,F3XN,4,6,0,0,10
968126,10/23 10:59 PM,F3XN,243,169,0,83,495
968125,10/23 10:57 PM,F6N,1,0,0,0,1
968124,10/23 10:56 PM,F3XN,24,23,0,49,96
968123,10/23 10:55 PM,F6N,2,0,0,0,2
968122,10/23 10:55 PM,F6N,1,0,0,0,1
968121,10/23 10:54 PM,F3N,46,34,0,1,81
968120,10/23 10:54 PM,F3N,32,30,0,4,66
968119,10/23 10:54 PM,F3XN,75,14,0,0,89
968118,10/23 10:53 PM,F3N,1,3,0,0,4
968117,10/23 10:52 PM,F3XN,55,22,0,55,132
968116,10/23 10:52 PM,F3XN,369,93,0,37,499
968115,10/23 10:51 PM,F3XN,0,0,2,4,6
968114,10/23 10:50 PM,F3A,7,21,0,0,28
968113,10/23 10:49 PM,F3XA,1,1,0,0,2
968112,10/23 10:47 PM,F6N,2,0,0,0,2
968111,10/23 10:46 PM,F6N,1,0,0,0,1
968110,10/23 10:45 PM,F3XN,76,3,0,76,155
968109,10/23 10:44 PM,F3N,63,21,0,0,84
968108,10/23 10:44 PM,F3N,3,0,0,15,18
968107,10/23 10:43 PM,F24N,0,0,18,0,18
968106,10/23 10:42 PM,F3XN,6,200,29,4,239
968105,10/23 10:42 PM,F3N,22,85,0,0,107
968104,10/23 10:42 PM,F3XN,1230,100,10,25,1365
968103,10/23 10:42 PM,F3XN,0,3,0,0,3
968102,10/23 10:41 PM,F5N,0,0,1,0,1
968101,10/23 10:41 PM,F3XN,34,114,0,0,148
968100,10/23 10:41 PM,F3N,41,15,0,4,60
968099,10/23 10:41 PM,F3N,3,13,0,5,21
968098,10/23 10:40 PM,F3XN,109,266,0,364,739
968097,10/23 10:39 PM,F3XN,19,5,0,0,24
968096,10/23 10:39 PM,F3XN,36,14,0,0,50
968095,10/23 10:38 PM,F3XN,3,3,0,0,6
968094,10/23 10:36 PM,F3XN,5,1,16,2,24
968093,10/23 10:36 PM,F3XA,4,4,0,0,8
968092,10/23 10:36 PM,F3XN,0,0,0,7,7
968091,10/23 10:36 PM,F3XN,1,1,0,0,2
968090,10/23 10:35 PM,F3N,86,70,0,1,157
968089,10/23 10:35 PM,F3XN,0,0,0,0,0
968088,10/23 10:35 PM,F3N,4,18,0,27,49
968086,10/23 10:34 PM,F3N,78,58,0,0,136
968085,10/23 10:33 PM,F3XN,0,6,0,0,6
968084,10/23 10:31 PM,F3N,84,61,0,6,151
968083,10/23 10:30 PM,F3XA,74,13,0,11,98
968082,10/23 10:30 PM,F3N,61,18,0,3,82
968081,10/23 10:30 PM,F3N,20,43,0,0,63
968080,10/23 10:30 PM,F3N,21,38,0,7,66
968079,10/23 10:29 PM,F3N,68,24,0,6,98
968078,10/23 10:29 PM,F3XN,1,0,0,11,12
968077,10/23 10:29 PM,F3N,64,37,0,3,104
968076,10/23 10:29 PM,F3N,44,37,0,0,81
968075,10/23 10:28 PM,F3N,35,19,0,1,55
968074,10/23 10:28 PM,F3XN,0,0,0,3,3
968073,10/23 10:28 PM,F3XN,5,1,0,0,6
968072,10/23 10:28 PM,F3XN,28,17,0,60,105
968071,10/23 10:27 PM,F3XN,0,4,0,2,6
968070,10/23 10:27 PM,F3N,2,16,0,1,19
968069,10/23 10:27 PM,F3XN,0,0,0,6,6
968068,10/23 10:27 PM,F3A,135,78,0,19,232
968067,10/23 10:26 PM,F3N,26,95,0,1,122
968066,10/23 10:26 PM,F3XN,0,0,0,2,2
968065,10/23 10:26 PM,F6N,5,0,0,0,5
968064,10/23 10:25 PM,F3XN,0,0,0,22,22
968063,10/23 10:25 PM,F3XN,30,11,0,51,92
968062,10/23 10:24 PM,F3N,110,24,0,16,150
968061,10/23 10:23 PM,F6N,3,0,0,0,3
968060,10/23 10:21 PM,F3XN,61,5,0,0,66
968059,10/23 10:21 PM,F3N,36,69,0,2,107
968058,10/23 10:20 PM,F3N,6,10,0,2,18
968057,10/23 10:18 PM,F3A,267,172,0,7,446
968056,10/23 10:17 PM,F3N,0,0,0,4,4
968055,10/23 10:17 PM,F3XN,79,233,0,102,414
968054,10/23 10:16 PM,F3N,14,7,0,6,27
968053,10/23 10:16 PM,F3N,23,21,0,21,65
968052,10/23 10:16 PM,F3N,1,7,0,20,28
968051,10/23 10:16 PM,F3XA,608,310,0,23,941
968050,10/23 10:15 PM,F3XN,18,43,0,99,160
968049,10/23 10:15 PM,F3XN,2,3,0,12,17
968048,10/23 10:15 PM,F3A,59,38,0,13,110
968047,10/23 10:14 PM,F6N,2,0,0,0,2
968046,10/23 10:13 PM,F3N,8,43,0,0,51
968045,10/23 10:13 PM,F3XN,0,0,0,10,10
968044,10/23 10:12 PM,F3XN,3,0,0,6,9
968043,10/23 10:12 PM,F3XN,10,12,0,0,22
968042,10/23 10:11 PM,F3XN,15,0,0,0,15
968041,10/23 10:10 PM,F3N,68,58,0,1,127
968040,10/23 10:10 PM,F3N,103,84,0,0,187
968039,10/23 10:10 PM,F3XN,1,16,0,0,17
968038,10/23 10:09 PM,F5N,0,0,1,0,1
968037,10/23 10:09 PM,F3N,166,48,0,0,214
968036,10/23 10:09 PM,F3XN,1,0,0,0,1
968035,10/23 10:07 PM,F6N,7,0,0,0,7
968034,10/23 10:07 PM,F3N,54,35,0,11,100
968033,10/23 10:07 PM,F3XN,0,0,0,0,0
968032,10/23 10:06 PM,F3XN,51,92,0,43,186
968031,10/23 10:06 PM,F24A,0,0,2,0,2
968030,10/23 10:06 PM,F3XN,0,0,0,0,0
968029,10/23 10:05 PM,F3N,17,29,0,12,58
968028,10/23 10:05 PM,F6N,5,0,0,0,5
968027,10/23 10:05 PM,F3XN,1,3,0,8,12
968026,10/23 10:05 PM,F3A,14,54,0,1,69
968025,10/23 10:04 PM,F3N,240,37,0,4,281
968024,10/23 10:04 PM,F3N,0,11,0,0,11
968023,10/23 10:03 PM,F3N,0,0,0,28,28
968022,10/23 10:03 PM,F3XN,67,0,0,280,347
968021,10/23 10:02 PM,F6N,1,0,0,0,1
968020,10/23 10:02 PM,F3N,2,0,0,5,7
968019,10/23 10:02 PM,F5N,0,0,1,0,1
968018,10/23 10:02 PM,F24N,0,0,5,0,5
968017,10/23 10:01 PM,F3XN,0,1,0,1,2
968016,10/23 10:00 PM,F3N,0,0,0,6,6
968015,10/23 10:00 PM,F24N,0,0,1,0,1
968014,10/23 09:59 PM,F3N,4,1,0,4,9
968013,10/23 09:59 PM,F3N,93,46,0,1,140
968012,10/23 09:58 PM,F3XN,32,223,0,56,311
968011,10/23 09:58 PM,F3N,206,56,0,1,263
968010,10/23 09:58 PM,F24N,0,0,1,0,1
968009,10/23 09:57 PM,F3XN,503,32,0,21,556
968008,10/23 09:56 PM,F3N,5,4,0,6,15
968007,10/23 09:56 PM,F3XN,39,165,0,186,390
968006,10/23 09:56 PM,F3N,132,21,0,120,273
968005,10/23 09:55 PM,F3XN,0,0,0,0,0
968004,10/23 09:55 PM,F6N,3,0,0,0,3
968003,10/23 09:54 PM,F3XN,0,0,0,0,0
968002,10/23 09:54 PM,F3N,452,99,0,0,551
968001,10/23 09:53 PM,F5N,0,0,2,0,2
968000,10/23 09:53 PM,F3XN,20,14,0,0,34
967999,10/23 09:52 PM,F5N,0,0,1,0,1
967998,10/23 09:51 PM,F3A,179,118,0,3,300
967997,10/23 09:51 PM,F6N,26,0,0,0,26
967996,10/23 09:51 PM,F3N,187,35,0,0,222
967995,10/23 09:51 PM,F3N,1504,57,0,0,1561
967994,10/23 09:49 PM,F3N,0,0,0,3,3
967993,10/23 09:49 PM,F3XN,0,0,0,1,1
967992,10/23 09:48 PM,F3XN,20,17,0,0,37
967991,10/23 09:47 PM,F3N,28,3,0,0,31
967990,10/23 09:47 PM,F3XN,87,32,0,0,119
967989,10/23 09:47 PM,F3N,4,13,0,5,22
967988,10/23 09:46 PM,F6N,1,0,0,0,1
967987,10/23 09:45 PM,F3XN,0,6,0,5,11
967986,10/23 09:45 PM,F99,0,0,0,0,0
967985,10/23 09:44 PM,F24N,0,0,5,0,5
967984,10/23 09:44 PM,F3XN,1,0,0,1,2
967983,10/23 09:44 PM,F3XN,458,25,6,0,489
967982,10/23 09:43 PM,F3XN,0,3,0,0,3
967981,10/23 09:42 PM,F3N,2,8,0,19,29
967980,10/23 09:42 PM,F3XN,0,0,0,0,0
967979,10/23 09:41 PM,F24N,0,0,6,0,6
967978,10/23 09:41 PM,F3N,166,37,0,0,203
967977,10/23 09:40 PM,F3N,50,21,0,0,71
967976,10/23 09:40 PM,F3XN,8,12,0,4,24
967975,10/23 09:39 PM,F3XN,9,2,0,26,37
967974,10/23 09:39 PM,F3N,249,77,0,0,326
967973,10/23 09:39 PM,F5N,0,0,1,0,1
967972,10/23 09:39 PM,F3N,804,95,0,1,900
967971,10/23 09:39 PM,F24N,0,0,3,0,3
967970,10/23 09:38 PM,F3N,0,0,0,22,22
967969,10/23 09:37 PM,F5N,0,0,12,0,12
967968,10/23 09:37 PM,F3N,148,25,0,7,180
967967,10/23 09:37 PM,F3XN,0,32,38,54,124
967966,10/23 09:37 PM,F3N,157,30,0,0,187
967965,10/23 09:37 PM,F3XN,47,16,0,20,83
967964,10/23 09:36 PM,F3N,43,26,0,32,101
967963,10/23 09:36 PM,F6N,1,0,0,0,1
967962,10/23 09:35 PM,F3XN,1,0,0,0,1
967961,10/23 09:35 PM,F3XN,23,12,0,63,98
967960,10/23 09:35 PM,F3XN,1,0,0,0,1
967959,10/23 09:35 PM,F3XN,24,3,0,0,27
967958,10/23 09:34 PM,F3XN,44,225,0,179,448
967957,10/23 09:34 PM,F3N,608,121,0,2,731
967956,10/23 09:34 PM,F3XN,0,0,0,0,0
967955,10/23 09:34 PM,F24N,0,0,4,0,4
967954,10/23 09:33 PM,F3XN,2,0,1,0,3
967953,10/23 09:33 PM,F6N,2,0,0,0,2
967952,10/23 09:33 PM,F3XN,1,3,0,10,14
967951,10/23 09:32 PM,F3A,182,55,0,33,270
967950,10/23 09:31 PM,F3XN,0,15,0,1,16
967949,10/23 09:31 PM,F3XN,0,0,0,0,0
967948,10/23 09:31 PM,F3N,329,71,0,0,400
967947,10/23 09:30 PM,F3N,31,23,0,3,57
967946,10/23 09:30 PM,F3XN,1,1,0,6,8
967945,10/23 09:30 PM,F24N,0,0,3,0,3
967944,10/23 09:29 PM,F6N,1,0,0,0,1
967943,10/23 09:29 PM,F24N,0,0,1,0,1
967942,10/23 09:29 PM,F3N,20,40,0,4,64
967941,10/23 09:29 PM,F3N,7,8,0,0,15
967940,10/23 09:28 PM,F3N,41,61,0,0,102
967939,10/23 09:28 PM,F3A,27,23,0,19,69
967938,10/23 09:28 PM,F3XN,0,8,0,0,8
967937,10/23 09:28 PM,F6N,1,0,0,0,1
967936,10/23 09:27 PM,F3XN,59,5,0,10,74
967935,10/23 09:26 PM,F3XN,13,0,0,0,13
967934,10/23 09:26 PM,F3XA,21,8,0,15,44
967933,10/23 09:25 PM,F6N,2,0,0,0,2
967932,10/23 09:25 PM,F3XN,0,1,0,0,1
967931,10/23 09:24 PM,F3N,15,10,0,1,26
967930,10/23 09:24 PM,F24N,0,0,4,0,4
967929,10/23 09:23 PM,F6N,2,0,0,0,2
967928,10/23 09:23 PM,F3N,148,117,0,49,314
967927,10/23 09:23 PM,F3XN,0,1,0,0,1
967926,10/23 09:22 PM,F24A,0,0,1,0,1
967925,10/23 09:22 PM,F3N,11,11,0,1,23
967924,10/23 09:21 PM,F3XN,0,0,0,0,0
967923,10/23 09:21 PM,F3XN,1,9,0,10,20
967922,10/23 09:21 PM,F3XN,3,1,0,15,19
967921,10/23 09:20 PM,F3XN,14,3,0,0,17
967920,10/23 09:20 PM,F3XN,0,0,0,0,0
967919,10/23 09:19 PM,F3XN,1143,205,142,28,1518
967918,10/23 09:19 PM,F3N,0,0,0,0,0
967917,10/23 09:19 PM,F3N,99,48,0,0,147
967916,10/23 09:19 PM,F3N,201,70,0,2,273
967915,10/23 09:19 PM,F3XA,8,51,0,20,79
967914,10/23 09:18 PM,F3XA,55,90,0,6,151
967913,10/23 09:18 PM,F24N,0,0,4,0,4
967912,10/23 09:17 PM,F3N,86,27,0,0,113
967911,10/23 09:17 PM,F3XN,18,34,0,0,52
967910,10/23 09:17 PM,F3N,172,70,0,0,242
967909,10/23 09:16 PM,F3XN,1,2,0,10,13
967908,10/23 09:16 PM,F3XN,2,7,0,0,9
967907,10/23 09:16 PM,F3XN,0,0,0,2,2
967906,10/23 09:16 PM,F3N,19,40,0,0,59
967905,10/23 09:14 PM,F3XN,0,11,0,0,11
967904,10/23 09:13 PM,F6N,1,0,0,1,2
967903,10/23 09:13 PM,F3XN,0,0,0,0,0
967902,10/23 09:13 PM,F3N,26,54,0,0,80
967901,10/23 09:12 PM,F3XN,14,31,0,0,45
967900,10/23 09:12 PM,F3N,136,44,0,0,180
967899,10/23 09:12 PM,F6A,17,0,0,1,18
967898,10/23 09:11 PM,F3XN,4160,49,0,1,4210
967897,10/23 09:11 PM,F3N,45,28,0,1,74
967896,10/23 09:11 PM,F3XN,0,2,0,0,2
967895,10/23 09:10 PM,F6N,14,0,0,1,15
967894,10/23 09:10 PM,F3XN,0,2,0,0,2
967893,10/23 09:09 PM,F3XN,0,2,0,1,3
967892,10/23 09:09 PM,F3XN,0,0,0,0,0
967891,10/23 09:09 PM,F24N,0,0,1,0,1
967890,10/23 09:09 PM,F3XN,0,0,0,0,0
967889,10/23 09:08 PM,F3XN,2,0,0,0,2
967888,10/23 09:07 PM,F3A,661,450,0,2,1113
967887,10/23 09:07 PM,F3N,38,28,0,1,67
967886,10/23 09:06 PM,F3XN,29,1,0,0,30
967885,10/23 09:06 PM,F3N,6,2,0,30,38
967884,10/23 09:06 PM,F3XN,48,0,0,64,112
967883,10/23 09:05 PM,F3N,4,1,0,0,5
967882,10/23 09:05 PM,F3N,3,0,0,0,3
967881,10/23 09:05 PM,F3N,21,25,0,0,46
967880,10/23 09:04 PM,F24N,0,0,1,0,1
967879,10/23 09:03 PM,F3XN,36,0,0,0,36
967878,10/23 09:02 PM,F6N,1,0,0,0,1
967877,10/23 09:02 PM,F24N,0,0,1,0,1
967876,10/23 09:01 PM,F3XN,66,21,0,9,96
967875,10/23 09:00 PM,F3XN,139,11,0,0,150
967874,10/23 09:00 PM,F3N,36,55,0,6,97
967873,10/23 08:59 PM,F3N,28,11,0,0,39
967872,10/23 08:59 PM,F3N,181,21,0,15,217
967871,10/23 08:58 PM,F3N,18,22,0,4,44
967870,10/23 08:57 PM,F3XN,65,361,0,0,426
967869,10/23 08:57 PM,F3XN,0,0,0,0,0
967868,10/23 08:57 PM,F3XN,1,52,0,0,53
967867,10/23 08:56 PM,F5N,0,0,1,0,1
967866,10/23 08:56 PM,F3A,350,400,0,61,811
967865,10/23 08:56 PM,F24N,0,0,1,0,1
967864,10/23 08:55 PM,F3N,16,24,0,0,40
967863,10/23 08:55 PM,F3XN,0,2,0,0,2
967862,10/23 08:55 PM,F3N,66,10,0,0,76
967861,10/23 08:55 PM,F3N,14,10,0,10,34
967860,10/23 08:55 PM,F24N,0,0,1,0,1
967859,10/23 08:55 PM,F3XN,4,3,0,0,7
967858,10/23 08:54 PM,F24N,0,0,1,0,1
967857,10/23 08:53 PM,F3N,15,79,0,0,94
967856,10/23 08:52 PM,F3N,136,69,0,0,205
967855,10/23 08:52 PM,F3N,800,86,0,5,891
967854,10/23 08:51 PM,F3XN,46,0,0,0,46
967853,10/23 08:51 PM,F24N,0,0,1,0,1
967852,10/23 08:51 PM,F3N,36,37,0,4,77
967851,10/23 08:50 PM,F3XN,0,0,0,3,3
967850,10/23 08:50 PM,F3N,368,94,0,2,464
967849,10/23 08:50 PM,F3N,11,28,0,5,44
967848,10/23 08:50 PM,F3N,12,8,0,6,26
967847,10/23 08:49 PM,F6N,4,0,0,0,4
967846,10/23 08:49 PM,F3N,97,25,0,8,130
967845,10/23 08:48 PM,F3N,112,52,0,1,165
967844,10/23 08:47 PM,F3XN,6,58,0,0,64
967843,10/23 08:46 PM,F3XN,1,3,0,0,4
967842,10/23 08:45 PM,F3XN,98,134,0,0,232
967841,10/23 08:45 PM,F3A,68,18,0,0,86
967840,10/23 08:45 PM,F24N,0,0,1,0,1
967839,10/23 08:44 PM,F3N,60,15,0,2,77
967838,10/23 08:44 PM,F3N,37,28,0,2,67
967837,10/23 08:44 PM,F3N,44,46,0,9,99
967836,10/23 08:43 PM,F3N,41,30,0,0,71
967835,10/23 08:43 PM,F3XA,25,4,0,0,29
967834,10/23 08:43 PM,F3N,37,13,0,3,53
967833,10/23 08:43 PM,F3N,3,6,0,15,24
967832,10/23 08:42 PM,F3A,153,73,0,2,228
967831,10/23 08:42 PM,F3XN,0,0,0,0,0
967830,10/23 08:41 PM,F3N,89,27,0,2,118
967829,10/23 08:41 PM,F3XN,25,3,0,0,28
967828,10/23 08:41 PM,F3A,59,27,0,2,88
967827,10/23 08:41 PM,F6N,17,0,0,0,17
967826,10/23 08:41 PM,F3N,79,51,0,8,138
967825,10/23 08:41 PM,F3XN,0,0,0,0,0
967824,10/23 08:40 PM,F3A,0,10,0,2,12
967823,10/23 08:40 PM,F3N,105,33,0,0,138
967822,10/23 08:40 PM,F3XN,0,0,0,0,0
967821,10/23 08:40 PM,F3N,141,31,0,10,182
967820,10/23 08:39 PM,F3A,46,18,0,2,66
967819,10/23 08:37 PM,F3A,252,157,0,1,410
967818,10/23 08:37 PM,F3XN,0,24,0,0,24
967817,10/23 08:36 PM,F3N,0,0,0,0,0
967816,10/23 08:36 PM,F3XN,0,4,0,0,4
967815,10/23 08:34 PM,F3N,5,2,0,0,7
967814,10/23 08:34 PM,F3XN,832,2,0,0,834
967813,10/23 08:34 PM,F3XN,93,2,0,0,95
967812,10/23 08:34 PM,F3N,7,33,0,0,40
967811,10/23 08:34 PM,F3N,4,5,0,0,9
967810,10/23 08:34 PM,F3XN,6,14,0,1,21
967809,10/23 08:33 PM,F3XN,86,91,0,6,183
967808,10/23 08:33 PM,F3N,116,30,0,2,148
967807,10/23 08:32 PM,F3N,8,2,0,0,10
967806,10/23 08:31 PM,F3XN,0,2,0,0,2
967805,10/23 08:31 PM,F3N,1013,186,0,0,1199
967804,10/23 08:30 PM,F3N,86,37,0,2,125
967803,10/23 08:30 PM,F3XN,3,8,10,2,23
967802,10/23 08:29 PM,F3A,1372,394,0,2,1768
967801,10/23 08:28 PM,F3XN,585,34,22,6,647
967800,10/23 08:28 PM,F6N,11,0,0,0,11
967799,10/23 08:27 PM,F3XN,36,33,0,93,162
967798,10/23 08:27 PM,F5N,0,0,1,0,1
967797,10/23 08:27 PM,F3N,12,7,0,11,30
967796,10/23 08:26 PM,F3XN,483,697,4,1,1185
967795,10/23 08:26 PM,F3XN,1,6,0,0,7
967794,10/23 08:25 PM,F3XN,8,0,0,0,8
967793,10/23 08:25 PM,F3XA,21,9,0,0,30
967792,10/23 08:25 PM,F3N,1314,167,0,4,1485
967791,10/23 08:24 PM,F3XN,156,431,0,79,666
967790,10/23 08:25 PM,F3N,145,72,0,7,224
967789,10/23 08:24 PM,F3XN,144,139,0,30,313
967788,10/23 08:24 PM,F24N,0,0,1,0,1
967787,10/23 08:24 PM,F6N,1,0,0,0,1
967786,10/23 08:23 PM,F3N,0,0,0,0,0
967785,10/23 08:23 PM,F3N,3,2,0,0,5
967784,10/23 08:22 PM,F3N,3,10,0,0,13
967783,10/23 08:21 PM,F3XN,115,13,0,0,128
967782,10/23 08:20 PM,F3XN,12,13,21,0,46
967781,10/23 08:20 PM,F6N,3,0,0,0,3
967780,10/23 08:20 PM,F3XN,35,28,0,64,127
967779,10/23 08:20 PM,F3N,16,102,0,0,118
967778,10/23 08:20 PM,F3XN,23,52,0,51,126
967777,10/23 08:20 PM,F3N,106,81,0,0,187
967776,10/23 08:20 PM,F3XN,58,77,0,55,190
967775,10/23 08:19 PM,F3N,5,0,0,1,6
967774,10/23 08:19 PM,F24A,0,0,5,0,5
967773,10/23 08:18 PM,F6N,3,0,0,0,3
967772,10/23 08:17 PM,F6N,1,0,0,0,1
967771,10/23 08:17 PM,F3XN,877,166,71,18,1132
967770,10/23 08:17 PM,F3N,989,56,0,0,1045
967769,10/23 08:17 PM,F3XN,67,2,0,0,69
967768,10/23 08:16 PM,F24N,0,0,8,0,8
967767,10/23 08:15 PM,F3N,10,12,0,4,26
967766,10/23 08:15 PM,F3N,71,43,0,1,115
967765,10/23 08:15 PM,F3N,36,21,0,12,69
967764,10/23 08:14 PM,F3XN,57,6,0,0,63
967763,10/23 08:14 PM,F3N,12,33,0,0,45
967762,10/23 08:14 PM,F3XN,0,5,0,0,5
967761,10/23 08:13 PM,F3A,253,117,0,17,387
967760,10/23 08:13 PM,F3N,291,86,0,7,384
967759,10/23 08:12 PM,F6N,4,0,0,0,4
967758,10/23 08:12 PM,F6N,5,0,0,0,5
967757,10/23 08:12 PM,F3N,172,76,0,0,248
967756,10/23 08:12 PM,F3N,52,16,0,0,68
967755,10/23 08:11 PM,F3XN,0,10,0,0,10
967754,10/23 08:11 PM,F3XN,990,26,0,0,1016
967753,10/23 08:11 PM,F3XN,72,98,0,8,178
967752,10/23 08:10 PM,F3XN,94,106,0,91,291
967751,10/23 08:10 PM,F6N,2,0,0,0,2
967750,10/23 08:10 PM,F6N,2,0,0,0,2
967749,10/23 08:10 PM,F6N,1,0,0,0,1
967748,10/23 08:09 PM,F3N,30,21,0,2,53
967747,10/23 08:09 PM,F3N,661,141,0,0,802
967746,10/23 08:08 PM,F3N,164,31,0,6,201
967745,10/23 08:08 PM,F6N,8,0,0,0,8
967744,10/23 08:07 PM,F3XN,17,2,0,0,19
967743,10/23 08:07 PM,F3A,56,240,0,10,306
967742,10/23 08:07 PM,F3N,154,35,0,0,189
967741,10/23 08:07 PM,F3XN,0,0,0,0,0
967740,10/23 08:06 PM,F6N,1,0,0,0,1
967739,10/23 08:06 PM,F3A,447,104,0,2,553
967738,10/23 08:06 PM,F3N,20,23,0,0,43
967737,10/23 08:05 PM,F3N,82,57,0,0,139
967736,10/23 08:05 PM,F3N,8,9,0,0,17
967735,10/23 08:04 PM,F6N,4,0,0,0,4
967734,10/23 08:04 PM,F3XN,15,47,0,80,142
967733,10/23 08:04 PM,F3N,205,60,0,3,268
967732,10/23 08:03 PM,F3N,37,44,0,0,81
967731,10/23 08:03 PM,F3XN,12,56,23,1,92
967730,10/23 08:02 PM,F3N,103,54,0,0,157
967729,10/23 08:00 PM,F3N,3,1,0,0,4
967728,10/23 08:00 PM,F3A,84,61,0,24,169
967727,10/23 07:58 PM,F3XN,88,44,0,43,175
967726,10/23 07:58 PM,F3XN,5,4,0,0,9
967725,10/23 07:58 PM,F3XN,55,90,0,6,151
967724,10/23 07:58 PM,F3XN,40,5,1,0,46
967723,10/23 07:57 PM,F6N,3,0,0,0,3
967722,10/23 07:57 PM,F3N,191,44,0,12,247
967721,10/23 07:57 PM,F3XN,0,0,0,0,0
967720,10/23 07:57 PM,F3XN,0,0,0,0,0
967719,10/23 07:56 PM,F3N,11,26,0,6,43
967718,10/23 07:56 PM,F3N,71,26,0,2,99
967717,10/23 07:56 PM,F3XA,23,12,0,1,36
967716,10/23 07:56 PM,F3XN,3,4,2,0,9
967715,10/23 07:56 PM,F3XN,101,85,0,0,186
967714,10/23 07:56 PM,F3N,616,56,0,0,672
967713,10/23 07:55 PM,F3N,430,65,0,2,497
967712,10/23 07:55 PM,F3XN,6,5,0,0,11
967711,10/23 07:55 PM,F3XA,9,4,2,0,15
967710,10/23 07:54 PM,F3N,0,0,0,4,4
967709,10/23 07:54 PM,F3N,13,13,0,1,27
967708,10/23 07:52 PM,F3N,22,65,0,1,88
967707,10/23 07:52 PM,F6N,5,0,0,0,5
967706,10/23 07:52 PM,F3XN,0,5,0,0,5
967705,10/23 07:51 PM,F6N,5,0,0,0,5
967704,10/23 07:51 PM,F3N,1207,58,0,0,1265
967703,10/23 07:51 PM,F3N,158,55,0,5,218
967702,10/23 07:51 PM,F3N,10,25,0,0,35
967701,10/23 07:50 PM,F3XN,12,4,0,34,50
967700,10/23 07:50 PM,F3XN,0,0,0,0,0
967699,10/23 07:49 PM,F3XN,509,29,10,1,549
967698,10/23 07:49 PM,F6N,4,0,0,0,4
967697,10/23 07:48 PM,F3XN,9,1,0,0,10
967696,10/23 07:48 PM,F3XN,66,16,0,0,82
967695,10/23 07:47 PM,F3XN,0,0,0,0,0
967694,10/23 07:47 PM,F99,0,0,0,0,0
967693,10/23 07:47 PM,F3N,487,58,0,0,545
967692,10/23 07:46 PM,F3XA,19,2,0,1,22
967691,10/23 07:46 PM,F5N,0,0,1,0,1
967690,10/23 07:46 PM,F3N,80,45,0,0,125
967689,10/23 07:46 PM,F3XA,197,165,0,182,544
967688,10/23 07:45 PM,F3N,0,0,0,0,0
967687,10/23 07:45 PM,F3XN,1,4,0,0,5
967686,10/23 07:45 PM,F3N,610,95,0,0,705
967685,10/23 07:44 PM,F3N,20,13,0,0,33
967684,10/23 07:44 PM,F3N,27,12,0,6,45
967683,10/23 07:43 PM,F3A,86,35,0,1,122
967682,10/23 07:43 PM,F3XN,0,3,0,0,3
967681,10/23 07:42 PM,F3N,167,67,0,0,234
967680,10/23 07:42 PM,F3XN,2,2,0,0,4
967679,10/23 07:42 PM,F3N,12,53,0,3,68
967678,10/23 07:42 PM,F3XN,20,1,0,24,45
967677,10/23 07:41 PM,F6N,2,0,0,0,2
967676,10/23 07:41 PM,F3XN,65,121,0,0,186
967675,10/23 07:40 PM,F3XN,24,0,0,0,24
967674,10/23 07:40 PM,F6N,4,0,0,0,4
967673,10/23 07:39 PM,F3A,96,49,0,0,145
967672,10/23 07:39 PM,F3N,220,34,0,0,254
967671,10/23 07:39 PM,F3N,36,72,0,3,111
967670,10/23 07:39 PM,F3XN,0,0,0,0,0
967669,10/23 07:38 PM,F3XN,8,12,0,0,20
967668,10/23 07:38 PM,F6N,5,0,0,0,5
967667,10/23 07:38 PM,F3N,50,40,0,0,90
967666,10/23 07:37 PM,F5N,0,0,2,0,2
967665,10/23 07:36 PM,F3XN,12,2,0,5,19
967664,10/23 07:36 PM,F3N,257,68,0,7,332
967663,10/23 07:35 PM,F3N,53,20,0,0,73
967662,10/23 07:35 PM,F3XN,89,126,0,25,240
967661,10/23 07:35 PM,F3N,470,23,0,0,493
967660,10/23 07:35 PM,F3XN,62,21,0,236,319
967659,10/23 07:34 PM,F3N,39,28,0,3,70
967658,10/23 07:34 PM,F3N,75,22,0,1,98
967657,10/23 07:33 PM,F3A,616,206,0,5,827
967656,10/23 07:33 PM,F3N,8,8,0,3,19
967655,10/23 07:33 PM,F5N,0,0,27,0,27
967654,10/23 07:33 PM,F6N,2,0,0,0,2
967653,10/23 07:32 PM,F6N,5,0,0,0,5
967652,10/23 07:32 PM,F6N,3,0,0,0,3
967651,10/23 07:32 PM,F3XN,5,39,0,0,44
967650,10/23 07:32 PM,F3N,47,21,0,2,70
967649,10/23 07:32 PM,F3N,260,57,0,0,317
967648,10/23 07:31 PM,F3XN,433,2,0,0,435
967647,10/23 07:31 PM,F3N,116,77,0,1,194
967646,10/23 07:30 PM,F6N,2,0,0,0,2
967645,10/23 07:30 PM,F3XN,0,0,0,0,0
967644,10/23 07:30 PM,F3XN,114,75,0,121,310
967643,10/23 07:29 PM,F6N,1,0,0,0,1
967642,10/23 07:29 PM,F3XN,4,5,0,0,9
967641,10/23 07:29 PM,F3N,223,24,0,0,247
967640,10/23 07:28 PM,F3N,3,0,0,0,3
967639,10/23 07:27 PM,F3N,0,8,0,0,8
967638,10/23 07:26 PM,F24A,0,0,30,0,30
967637,10/23 07:25 PM,F3N,66,75,0,11,152
967636,10/23 07:25 PM,F3N,76,35,0,2,113
967635,10/23 07:25 PM,F3XN,0,0,0,0,0
967634,10/23 07:25 PM,F3XN,110,71,0,88,269
967633,10/23 07:25 PM,F3XN,129,179,1,242,551
967632,10/23 07:24 PM,F99,0,0,0,0,0
967631,10/23 07:23 PM,F3N,1014,82,0,0,1096
967630,10/23 07:23 PM,F3XN,0,0,0,77,77
967629,10/23 07:23 PM,F3N,10165,61,0,0,10226
967628,10/23 07:23 PM,F3XN,164,34,0,0,198
967627,10/23 07:23 PM,F3A,204,104,0,1,309
967626,10/23 07:23 PM,F6N,2,0,0,0,2
967625,10/23 07:23 PM,F3N,82,23,0,0,105
967624,10/23 07:23 PM,F3N,0,0,0,3,3
967623,10/23 07:23 PM,F3N,27,50,0,3,80
967622,10/23 07:22 PM,F3XN,0,10,0,0,10
967621,10/23 07:22 PM,F3N,25,33,0,1,59
967620,10/23 07:22 PM,F3N,31,11,0,0,42
967619,10/23 07:21 PM,F3N,16,51,0,0,67
967618,10/23 07:21 PM,F99,0,0,0,0,0
967617,10/23 07:21 PM,F3A,42,5,0,0,47
967616,10/23 07:21 PM,F3N,25,24,0,0,49
967615,10/23 07:20 PM,F3XN,0,3,0,0,3
967614,10/23 07:20 PM,F3XN,0,0,0,12,12
967613,10/23 07:20 PM,F3N,1303,65,0,0,1368
967612,10/23 07:20 PM,F6N,1,0,0,0,1
967611,10/23 07:19 PM,F99,0,0,0,0,0
967610,10/23 07:19 PM,F3N,46,12,0,1,59
967609,10/23 07:18 PM,F6N,10,0,0,0,10
967608,10/23 07:18 PM,F3XN,34,14,0,0,48
967607,10/23 07:18 PM,F3A,4,8,0,11,23
967606,10/23 07:17 PM,F3XA,4,26,31,0,61
967605,10/23 07:17 PM,F3XN,1,0,0,1,2
967604,10/23 07:17 PM,F6N,2,0,0,0,2
967603,10/23 07:17 PM,F3N,0,3,0,0,3
967602,10/23 07:16 PM,F3A,84,135,0,0,219
967601,10/23 07:16 PM,F3A,34,17,0,17,68
967600,10/23 07:15 PM,F3XN,0,4,0,0,4
967599,10/23 07:15 PM,F24N,0,0,1,0,1
967598,10/23 07:15 PM,F3N,157,82,0,7,246
967597,10/23 07:15 PM,F99,0,0,0,0,0
967596,10/23 07:14 PM,F3XN,11,1,0,2,14
967595,10/23 07:14 PM,F6N,1,0,0,0,1
967594,10/23 07:13 PM,F3N,37,28,0,1,66
967593,10/23 07:13 PM,F6N,3,0,0,0,3
967592,10/23 07:12 PM,F3N,25,46,0,3,74
967591,10/23 07:12 PM,F3XN,854,6,0,0,860
967590,10/23 07:12 PM,F3N,408,76,0,1,485
967589,10/23 07:12 PM,F3XN,0,5,0,0,5
967588,10/23 07:11 PM,F3N,408,76,0,0,484
967587,10/23 07:10 PM,F3N,115,46,0,1,162
967586,10/23 07:10 PM,F3XN,0,1,1,0,2
967585,10/23 07:10 PM,F6N,8,0,0,0,8
967584,10/23 07:10 PM,F6N,5,0,0,0,5
967583,10/23 07:09 PM,F6N,2,0,0,0,2
967582,10/23 07:09 PM,F24N,0,0,8,0,8
967581,10/23 07:09 PM,F3XN,133,0,0,0,133
967580,10/23 07:08 PM,F3XN,0,1,0,0,1
967579,10/23 07:08 PM,F3N,192,25,0,0,217
967578,10/23 07:08 PM,F3N,144,48,0,2,194
967577,10/23 07:08 PM,F3XN,2,2,0,0,4
967576,10/23 07:08 PM,F3XN,1,4,0,0,5
967575,10/23 07:07 PM,F3N,3,7,0,3,13
967574,10/23 07:07 PM,F3XN,0,2,0,0,2
967573,10/23 07:07 PM,F3N,49,46,0,0,95
967572,10/23 07:07 PM,F3XN,0,0,0,0,0
967571,10/23 07:07 PM,F3N,142,94,0,0,236
967570,10/23 07:07 PM,F3XN,4,0,0,0,4
967569,10/23 07:07 PM,F3XN,0,0,0,0,0
967568,10/23 07:06 PM,F3N,21,27,0,1,49
967567,10/23 07:06 PM,F3XN,25,1,0,0,26
967566,10/23 07:05 PM,F3N,52,39,0,0,91
967565,10/23 07:05 PM,F3XN,4,2,0,0,6
967564,10/23 07:05 PM,F6N,2,0,0,0,2
967563,10/23 07:04 PM,F3XN,0,0,0,0,0
967562,10/23 07:03 PM,F3XN,63,0,0,0,63
967561,10/23 07:03 PM,F3XN,5,36,0,0,41
967560,10/23 07:03 PM,F3XN,1,1,0,0,2
967559,10/23 07:03 PM,F3N,430,82,0,0,512
967558,10/23 07:03 PM,F3XN,65,7,0,62,134
967557,10/23 07:02 PM,F6N,1,0,0,0,1
967556,10/23 07:02 PM,F3A,34,15,0,3,52
967555,10/23 07:02 PM,F3N,165,44,0,9,218
967554,10/23 07:02 PM,F6N,4,0,0,0,4
967553,10/23 07:02 PM,F3XN,12,13,0,8,33
967552,10/23 07:01 PM,F3XN,16,1,0,0,17
967551,10/23 07:00 PM,F3N,101,32,0,2,135
967550,10/23 07:00 PM,F6N,2,0,0,0,2
967549,10/23 07:00 PM,F3N,0,21,0,18,39
967548,10/23 06:59 PM,F3XN,3,5,0,3,11
967547,10/23 06:59 PM,F3XN,0,0,0,0,0
967546,10/23 06:59 PM,F3XN,294,192,0,344,830
967545,10/23 06:58 PM,F3XN,6,3,0,0,9
967544,10/23 06:58 PM,F3N,77,36,0,1,114
967543,10/23 06:57 PM,F3XN,1,0,0,1,2
967542,10/23 06:56 PM,F3XN,0,2,0,0,2
967541,10/23 06:56 PM,F3XN,0,0,0,0,0
967540,10/23 06:56 PM,F3N,13,35,0,0,48
967539,10/23 06:56 PM,F3XN,0,0,0,0,0
967538,10/23 06:56 PM,F24N,0,0,1,0,1
967537,10/23 06:56 PM,F24N,0,0,3,0,3
967536,10/23 06:56 PM,F3XN,262,124,0,68,454
967535,10/23 06:54 PM,F3N,35,31,0,0,66
967534,10/23 06:53 PM,F3A,375,154,0,1,530
967533,10/23 06:51 PM,F3XN,0,0,0,0,0
967532,10/23 06:51 PM,F3XN,0,0,0,0,0
967531,10/23 06:50 PM,F3N,234,80,0,2,316
967530,10/23 06:50 PM,F3XN,121,56,0,0,177
967529,10/23 06:49 PM,F3N,50,15,0,7,72
967528,10/23 06:48 PM,F3XN,583,26,0,0,609
967527,10/23 06:48 PM,F3XN,0,2,0,0,2
967526,10/23 06:48 PM,F3N,43,19,0,0,62
967525,10/23 06:47 PM,F3N,92,51,0,7,150
967524,10/23 06:47 PM,F3N,378,43,0,0,421
967523,10/23 06:47 PM,F3XN,235,0,0,0,235
967522,10/23 06:46 PM,F6N,3,0,0,0,3
967521,10/23 06:46 PM,F3N,163,32,0,1,196
967520,10/23 06:46 PM,F3N,0,3,0,0,3
967519,10/23 06:44 PM,F6N,8,0,0,0,8
967518,10/23 06:43 PM,F3XN,120,27,11,9,167
967517,10/23 06:42 PM,F3A,1,25,0,0,26
967516,10/23 06:42 PM,F6N,1,0,0,0,1
967515,10/23 06:42 PM,F3XN,46,1,0,0,47
967514,10/23 06:41 PM,F3XN,0,0,0,0,0
967513,10/23 06:39 PM,F6N,27,0,0,0,27
967512,10/23 06:39 PM,F3XN,0,0,0,0,0
967511,10/23 06:39 PM,F3XN,27,0,0,0,27
967510,10/23 06:38 PM,F3XN,1,1,0,0,2
967509,10/23 06:37 PM,F3XN,125041,1689,202,35,126967
967508,10/23 06:38 PM,F3N,20,57,0,0,77
967507,10/23 06:37 PM,F3XN,9,4,0,0,13
967506,10/23 06:37 PM,F3XN,1,1,0,0,2
967505,10/23 06:37 PM,F6N,5,0,0,0,5
967504,10/23 06:36 PM,F3N,59,34,0,0,93
967503,10/23 06:36 PM,F6N,1,0,0,0,1
967502,10/23 06:36 PM,F24N,0,0,1,0,1
967501,10/23 06:36 PM,F3N,142,36,0,11,189
967500,10/23 06:36 PM,F3N,10,26,0,1,37
967499,10/23 06:35 PM,F3N,13,15,0,0,28
967498,10/23 06:34 PM,F3XN,478,216,0,0,694
967497,10/23 06:34 PM,F3XN,1,4,0,0,5
967496,10/23 06:34 PM,F6N,1,0,0,0,1
967495,10/23 06:33 PM,F3XN,0,0,0,0,0
967494,10/23 06:33 PM,F3N,23,38,0,7,68
967493,10/23 06:33 PM,F3XN,0,0,0,13,13
967492,10/23 06:32 PM,F3N,52,26,0,2,80
967491,10/23 06:32 PM,F3XN,55,5,0,1,61
967490,10/23 06:32 PM,F3N,265,50,0,1,316
967489,10/23 06:31 PM,F3N,177,21,0,0,198
967488,10/23 06:30 PM,F3N,36,15,0,11,62
967487,10/23 06:30 PM,F3XN,130,5,0,0,135
967486,10/23 06:30 PM,F3XN,44,5,0,0,49
967485,10/23 06:30 PM,F3XN,46,42,0,1,89
967484,10/23 06:29 PM,F6N,1,0,0,0,1
967483,10/23 06:27 PM,F24A,0,0,2,1,3
967482,10/23 06:27 PM,F24N,0,0,1,0,1
967481,10/23 06:27 PM,F3XN,0,0,0,0,0
967480,10/23 06:27 PM,F3N,9,41,0,57,107
967479,10/23 06:26 PM,F3XN,0,0,0,0,0
967478,10/23 06:26 PM,F3N,20,28,0,0,48
967477,10/23 06:26 PM,F3N,13,23,0,12,48
967476,10/23 06:26 PM,F3XN,61,21,6,0,88
967475,10/23 06:24 PM,F6N,5,0,0,0,5
967474,10/23 06:23 PM,F3XN,454,19,0,0,473
967473,10/23 06:23 PM,F3XN,0,3,0,0,3
967472,10/23 06:23 PM,F24N,0,0,6,0,6
967471,10/23 06:23 PM,F3XN,0,25,0,0,25
967470,10/23 06:22 PM,F24A,0,0,2,1,3
967469,10/23 06:22 PM,F24N,0,0,1,0,1
967468,10/23 06:21 PM,F3N,13,31,0,0,44
967467,10/23 06:21 PM,F3N,22,17,0,1,40
967466,10/23 06:21 PM,F6N,3,0,0,0,3
967465,10/23 06:21 PM,F3XN,2,5,0,0,7
967464,10/23 06:20 PM,F6N,5,0,0,0,5
967463,10/23 06:19 PM,F3XN,0,0,0,0,0
967462,10/23 06:19 PM,F3XN,0,1,0,0,1
967461,10/23 06:19 PM,F3XN,2,0,0,0,2
967460,10/23 06:19 PM,F3XN,5,14,0,0,19
967458,10/23 06:18 PM,F3XN,57,1,0,0,58
967457,10/23 06:18 PM,F3XN,1,0,0,0,1
967456,10/23 06:18 PM,F3XN,40,12,0,0,52
967455,10/23 06:18 PM,F3XN,1,0,2,0,3
967454,10/23 06:17 PM,F3XN,0,0,0,0,0
967453,10/23 06:17 PM,F3N,225,91,0,2,318
967452,10/23 06:17 PM,F3N,696,87,0,0,783
967451,10/23 06:16 PM,F99,0,0,0,0,0
967450,10/23 06:16 PM,F3XN,0,0,0,0,0
967449,10/23 06:16 PM,F3N,40,112,0,0,152
967448,10/23 06:15 PM,F6N,1,0,0,0,1
967447,10/23 06:15 PM,F3A,263,181,0,1,445
967446,10/23 06:15 PM,F3XN,10,8,0,0,18
967445,10/23 06:15 PM,F3XN,316,71,0,281,668
967444,10/23 06:15 PM,F24N,0,0,2,0,2
967443,10/23 06:14 PM,F24A,0,0,4,1,5
967442,10/23 06:14 PM,F3XN,51,10,0,26,87
967441,10/23 06:14 PM,F3N,181,37,0,6,224
967440,10/23 06:14 PM,F3XN,128,1,0,1,130
967439,10/23 06:13 PM,F3XN,6687,499,158,29,7373
967438,10/23 06:12 PM,F6N,4,0,0,0,4
967437,10/23 06:12 PM,F3XN,14,4,0,0,18
967436,10/23 06:12 PM,F3N,381,78,0,17,476
967435,10/23 06:12 PM,F3XN,131,110,0,0,241
967434,10/23 06:11 PM,F3XN,4,0,0,0,4
967433,10/23 06:10 PM,F3XN,0,0,0,0,0
967432,10/23 06:10 PM,F3XN,0,0,0,1,1
967431,10/23 06:10 PM,F6N,1,0,0,0,1
967430,10/23 06:09 PM,F3N,197,46,0,1,244
967429,10/23 06:09 PM,F6N,1,0,0,0,1
967428,10/23 06:08 PM,F3XN,0,0,0,0,0
967427,10/23 06:08 PM,F1A,0,0,0,0,0
967426,10/23 06:08 PM,F3XN,0,1,0,0,1
967425,10/23 06:08 PM,F5N,0,0,1,0,1
967424,10/23 06:08 PM,F3N,125,80,0,0,205
967423,10/23 06:07 PM,F3A,29,167,0,54,250
967422,10/23 06:06 PM,F3XN,0,0,0,0,0
967421,10/23 06:06 PM,F3N,109,27,0,17,153
967420,10/23 06:06 PM,F24N,0,0,7,0,7
967419,10/23 06:04 PM,F3A,326,158,0,0,484
967418,10/23 06:04 PM,F3N,735,75,0,0,810
967417,10/23 06:04 PM,F3XN,39,44,0,13,96
967416,10/23 06:04 PM,F3N,56,70,0,0,126
967415,10/23 06:04 PM,F3XN,1,0,2,0,3
967414,10/23 06:04 PM,F6N,4,0,0,0,4
967413,10/23 06:03 PM,F3XN,3,8,4,5,20
967412,10/23 06:03 PM,F3XN,23215,897,0,13,24125
967411,10/23 06:02 PM,F3XN,163,21,0,0,184
967410,10/23 06:02 PM,F3XN,67,0,0,0,67
967409,10/23 06:02 PM,F3XN,160,309,0,35,504
967408,10/23 06:01 PM,F3N,110,66,0,3,179
967407,10/23 06:01 PM,F3XA,2,2,0,1,5
967406,10/23 06:00 PM,F3N,58,26,0,0,84
967405,10/23 06:00 PM,F3N,12,31,0,0,43
967404,10/23 05:59 PM,F3A,40,30,0,24,94
967403,10/23 05:59 PM,F3A,30,16,0,19,65
967402,10/23 05:59 PM,F6N,7,0,0,0,7
967401,10/23 05:59 PM,F24N,0,0,1,0,1
967400,10/23 05:58 PM,F3XN,955,1450,0,5,2410
967399,10/23 05:58 PM,F1A,0,0,0,0,0
967398,10/23 05:58 PM,F3N,289,49,0,5,343
967397,10/23 05:58 PM,F3XN,577,13,0,0,590
967396,10/23 05:57 PM,F6N,3,0,0,0,3
967395,10/23 05:57 PM,F3XN,0,9,0,0,9
967394,10/23 05:57 PM,F3N,21,35,0,5,61
967393,10/23 05:57 PM,F6N,1,0,0,0,1
967392,10/23 05:56 PM,F3XN,1158,45,21,7,1231
967391,10/23 05:56 PM,F3XA,2,7,0,1,10
967390,10/23 05:56 PM,F3N,17,38,0,0,55
967389,10/23 05:56 PM,F3XN,10,0,0,0,10
967388,10/23 05:56 PM,F5N,0,0,7,0,7
967387,10/23 05:56 PM,F3XN,0,1,2,0,3
967386,10/23 05:56 PM,F3XN,2,11,0,0,13
967385,10/23 05:55 PM,F3XN,0,0,0,0,0
967384,10/23 05:55 PM,F3A,54,99,0,7,160
967383,10/23 05:54 PM,F6N,5,0,0,0,5
967382,10/23 05:54 PM,F24N,0,0,58,0,58
967381,10/23 05:54 PM,F3N,11,86,0,57,154
967380,10/23 05:54 PM,F3N,15,12,0,0,27
967379,10/23 05:53 PM,F5N,0,0,2,0,2
967378,10/23 05:52 PM,F3XN,430,9,0,0,439
967377,10/23 05:52 PM,F6N,5,0,0,0,5
967376,10/23 05:52 PM,F3N,4,13,0,2,19
967375,10/23 05:51 PM,F3XN,101,82,0,0,183
967374,10/23 05:50 PM,F3XN,27,13,0,32,72
967373,10/23 05:49 PM,F3N,34,7,0,0,41
967372,10/23 05:49 PM,F3XA,11,8,0,1,20
967371,10/23 05:49 PM,F3N,9,6,0,2,17
967370,10/23 05:49 PM,F3N,16,36,0,4,56
967369,10/23 05:48 PM,F3T,0,2,0,0,2
967368,10/23 05:48 PM,F3XN,0,1,0,0,1
967367,10/23 05:48 PM,F3N,90,25,0,0,115
967366,10/23 05:48 PM,F3XN,112,54,0,48,214
967365,10/23 05:48 PM,F3XN,176,8,0,0,184
967364,10/23 05:48 PM,F3XN,11,17,0,0,28
967363,10/23 05:48 PM,F3XN,286,0,0,0,286
967362,10/23 05:47 PM,F3XN,48,113,0,156,317
967361,10/23 05:47 PM,F3N,54,28,0,2,84
967360,10/23 05:47 PM,F3XN,0,5,0,0,5
967359,10/23 04:56 PM,F5N,0,0,2,0,2
967358,10/23 05:46 PM,F3XN,295,43,0,0,338
967357,10/23 05:45 PM,F3N,117,61,0,2,180
967356,10/23 05:44 PM,F3N,0,0,0,0,0
967355,10/23 05:44 PM,F3XA,1,2,0,1,4
967354,10/23 05:44 PM,F3N,45,50,0,1,96
967353,10/23 05:43 PM,F3N,340,39,0,0,379
967352,10/23 05:43 PM,F24N,0,0,1,0,1
967351,10/23 05:42 PM,F3XN,716,28,1,1,746
967350,10/23 05:42 PM,F3XN,77,2,0,0,79
967349,10/23 05:42 PM,F3A,649,219,0,0,868
967348,10/23 05:42 PM,F5N,0,0,3,0,3
967347,10/23 05:41 PM,F3XN,20,11,2,1,34
967346,10/23 05:40 PM,F3XN,21,16,0,0,37
967345,10/23 05:40 PM,F3XN,225,0,0,0,225
967344,10/23 05:39 PM,F6A,3,0,0,0,3
967343,10/23 05:39 PM,F3XN,0,1,0,0,1
967342,10/23 05:39 PM,F3XN,379,8,0,0,387
967341,10/23 05:39 PM,F3XN,2,3,0,2,7
967340,10/23 05:38 PM,F3XA,2,6,0,1,9
967339,10/23 05:38 PM,F3XA,537,287,0,0,824
967338,10/23 05:38 PM,F3XN,1,0,0,0,1
967337,10/23 05:38 PM,F3N,6,2,0,0,8
967336,10/23 05:38 PM,F3A,45,48,0,2,95
967335,10/23 05:37 PM,F3XA,556,135,0,0,691
967334,10/23 05:36 PM,F3XN,129,7,0,0,136
967333,10/23 05:36 PM,F3XN,0,0,0,0,0
967332,10/23 05:36 PM,F3XN,0,14,0,0,14
967331,10/23 05:35 PM,F3N,5,1,0,1,7
967330,10/23 05:35 PM,F3XN,89,70,0,0,159
967329,10/23 05:34 PM,F3N,63,48,0,19,130
967328,10/23 05:33 PM,F3XN,7,0,0,0,7
967327,10/23 05:33 PM,F3N,35,82,0,2,119
967326,10/23 05:32 PM,F3XN,194,47,0,0,241
967325,10/23 05:32 PM,F3XA,140,32,0,268,440
967324,10/23 05:32 PM,F3N,0,2,0,2,4
967323,10/23 05:32 PM,F3XN,15,14,0,8,37
967322,10/23 05:32 PM,F3XN,2,1,0,1,4
967321,10/23 05:32 PM,F3XN,0,2,0,0,2
967320,10/23 05:32 PM,F3N,375,59,0,2,436
967319,10/23 05:31 PM,F3N,45,20,0,6,71
967318,10/23 05:31 PM,F3XN,0,1,0,0,1
967317,10/23 05:31 PM,F3XN,46,1623,587,3,2259
967316,10/23 05:30 PM,F3XN,73,16,0,0,89
967315,10/23 05:30 PM,F3XA,0,1,0,1,2
967314,10/23 05:30 PM,F3N,119,45,0,0,164
967313,10/23 05:29 PM,F3XN,97,0,0,0,97
967312,10/23 05:26 PM,F3XN,10,2,0,0,12
967311,10/23 05:26 PM,F6N,1,0,0,0,1
967310,10/23 05:26 PM,F3XN,0,0,0,0,0
967309,10/23 05:25 PM,F3N,6,11,0,0,17
967308,10/23 05:24 PM,F3N,463,121,0,0,584
967307,10/23 05:23 PM,F3N,285,29,0,3,317
967306,10/23 05:23 PM,F3XN,82,0,0,0,82
967305,10/23 05:22 PM,F3XN,27,28,14,0,69
967304,10/23 05:22 PM,F6N,3,0,0,0,3
967303,10/23 05:22 PM,F3N,0,0,0,34,34
967302,10/23 05:22 PM,F3XN,1,0,0,0,1
967301,10/23 05:22 PM,F3N,5,25,0,0,30
967300,10/23 05:21 PM,F3XN,1,0,0,0,1
967299,10/23 05:21 PM,F3XN,1341,15,8,3,1367
967298,10/23 05:20 PM,F3N,65,40,0,40,145
967297,10/23 05:20 PM,F3XN,132,26,0,0,158
967296,10/23 05:20 PM,F3XN,58,6,0,0,64
967295,10/23 05:19 PM,F3XN,31,0,0,0,31
967294,10/23 05:19 PM,F3N,0,0,0,0,0
967293,10/23 05:19 PM,F3XN,89,2,0,0,91
967292,10/23 05:18 PM,F3A,66,71,0,13,150
967291,10/23 05:18 PM,F3XN,5,4,0,0,9
967290,10/23 05:18 PM,F3N,71,40,0,8,119
967289,10/23 05:18 PM,F6N,1,0,0,0,1
967288,10/23 05:18 PM,F6N,1,0,0,0,1
967287,10/23 05:17 PM,F3XN,3,11,0,0,14
967286,10/23 05:17 PM,F3XN,61,32,0,0,93
967285,10/23 05:17 PM,F3XN,1,1,0,0,2
967284,10/23 05:17 PM,F3N,28,32,0,0,60
967283,10/23 05:16 PM,F3N,54,27,0,6,87
967282,10/23 05:16 PM,F3XN,0,0,0,0,0
967281,10/23 05:16 PM,F3XN,0,0,0,0,0
967280,10/23 05:16 PM,F3XN,16493,684,0,51,17228
967279,10/23 05:16 PM,F3XN,60,150,0,16,226
967278,10/23 05:16 PM,F3XN,167,4,0,0,171
967277,10/23 05:16 PM,F6N,1,0,0,0,1
967276,10/23 05:15 PM,F3XN,2,0,0,0,2
967275,10/23 05:15 PM,F3XN,90,16,0,0,106
967274,10/23 05:15 PM,F3N,25,25,0,0,50
967273,10/23 05:15 PM,F3XN,19,1,0,0,20
967272,10/23 05:15 PM,F3N,192,98,0,1,291
967271,10/23 05:15 PM,F3XN,17,12,0,0,29
967270,10/23 05:14 PM,F3N,85,14,0,8,107
967269,10/23 05:14 PM,F3XN,4,0,0,0,4
967268,10/23 05:14 PM,F3N,0,1,0,7,8
967267,10/23 05:14 PM,F3XN,132,0,0,0,132
967266,10/23 05:13 PM,F3XN,0,1,0,0,1
967265,10/23 05:13 PM,F3N,27,33,0,6,66
967264,10/23 05:13 PM,F3XN,9908,8545,42,1,18496
967263,10/23 05:13 PM,F3N,72,10,0,0,82
967262,10/23 05:13 PM,F3N,608,103,0,0,711
967261,10/23 05:12 PM,F3XA,0,1,0,0,1
967260,10/23 05:12 PM,F3N,44,18,0,3,65
967259,10/23 05:12 PM,F3XN,0,0,0,9,9
967258,10/23 05:12 PM,F24N,0,0,2,0,2
967257,10/23 05:12 PM,F3N,0,28,0,0,28
967256,10/23 05:12 PM,F3N,23,11,0,1,35
967255,10/23 05:11 PM,F3N,3,4,0,1,8
967254,10/23 05:11 PM,F3XN,10,0,0,0,10
967253,10/23 05:11 PM,F3XN,430,18,0,0,448
967252,10/23 05:10 PM,F3XN,2672,14,0,0,2686
967251,10/23 05:10 PM,F3XN,34,2,1,1,38
967250,10/23 05:10 PM,F3XN,109,25,0,0,134
967249,10/23 05:10 PM,F3N,65,22,0,2,89
967248,10/23 05:10 PM,F3XN,4,10,0,0,14
967247,10/23 05:10 PM,F3N,71,53,0,6,130
967246,10/23 05:10 PM,F3N,39,19,0,7,65
967245,10/23 05:09 PM,F3XA,0,0,0,5,5
967244,10/23 05:09 PM,F6N,2,0,0,0,2
967243,10/23 05:09 PM,F3XN,0,1,0,0,1
967242,10/23 05:09 PM,F3XN,112,0,0,0,112
967241,10/23 05:09 PM,F3XN,0,2,0,0,2
967240,10/23 05:09 PM,F3XN,13,5,0,0,18
967239,10/23 05:08 PM,F3XN,233,36,0,0,269
967238,10/23 05:08 PM,F3XN,20,5,0,0,25
967237,10/23 05:08 PM,F99,0,0,0,0,0
967236,10/23 05:08 PM,F3XN,232,7,1,1,241
967235,10/23 05:08 PM,F3XN,1,2,0,0,3
967234,10/23 05:08 PM,F3XN,1120,0,0,0,1120
967233,10/23 05:08 PM,F3N,28,13,0,1,42
967232,10/23 05:07 PM,F3XN,638,60,5,0,703
967231,10/23 05:07 PM,F3XN,12,0,0,0,12
967230,10/23 05:07 PM,F3XA,129,18,0,50,197
967229,10/23 05:06 PM,F3XN,58,1,0,0,59
967228,10/23 05:06 PM,F3N,46,27,0,0,73
967227,10/23 05:06 PM,F3N,96,47,0,6,149
967226,10/23 05:06 PM,F3XN,0,2,0,0,2
967225,10/23 05:06 PM,F3XN,0,0,0,0,0
967224,10/23 05:05 PM,F3XN,156,12,0,1,169
967223,10/23 05:05 PM,F3N,130,66,0,0,196
967222,10/23 05:05 PM,F3N,53,12,0,0,65
967221,10/23 05:05 PM,F3XN,0,0,0,0,0
967220,10/23 05:05 PM,F3XN,15,18,0,4,37
967219,10/23 05:05 PM,F3N,1,2,0,4,7
967218,10/23 05:04 PM,F3XN,308,7,0,0,315
967217,10/23 05:04 PM,F3N,9,26,0,0,35
967216,10/23 05:04 PM,F6N,6,0,0,0,6
967215,10/23 05:04 PM,F3XN,0,0,0,2,2
967214,10/23 05:04 PM,F3XA,21,50,0,0,71
967213,10/23 05:04 PM,F3XN,0,0,0,4,4
967212,10/23 05:04 PM,F3XN,614,32,0,0,646
967211,10/23 05:03 PM,F6N,1,0,0,0,1
967210,10/23 05:03 PM,F3N,258,68,0,0,326
967209,10/23 05:02 PM,F3N,138,48,0,0,186
967208,10/23 05:02 PM,F3XN,39,20,25,3,87
967207,10/23 05:02 PM,F3N,88,49,0,0,137
967206,10/23 05:02 PM,F6N,3,0,0,0,3
967205,10/23 05:02 PM,F3N,13,13,0,0,26
967204,10/23 05:02 PM,F3N,0,12,0,7,19
967203,10/23 05:02 PM,F3XN,0,20,0,0,20
967202,10/23 05:01 PM,F3N,26,18,0,1,45
967201,10/23 05:01 PM,F3XN,1,4,0,0,5
967200,10/23 05:00 PM,F3N,360,124,0,0,484
967199,10/23 05:00 PM,F3N,17,37,0,2,56
967198,10/23 04:59 PM,F3N,17,29,0,0,46
967197,10/23 04:59 PM,F3XN,60,23,21,8,112
967196,10/23 04:59 PM,F3XN,87,0,0,0,87
967195,10/23 04:59 PM,F3N,36,32,0,1,69
967194,10/23 04:59 PM,F3N,52,20,0,32,104
967193,10/23 04:58 PM,F3N,79,59,0,0,138
967192,10/23 04:58 PM,F3XN,18,6,0,45,69
967191,10/23 04:58 PM,F5N,0,0,1,0,1
967190,10/23 04:58 PM,F3XN,1,8,0,7,16
967189,10/23 04:58 PM,F3XN,1,0,0,0,1
967188,10/23 04:58 PM,F6N,3,0,0,0,3
967187,10/23 04:57 PM,F6N,8,0,0,0,8
967186,10/23 04:57 PM,F6N,6,0,0,0,6
967185,10/23 04:56 PM,F3N,3,37,0,6,46
967184,10/23 04:56 PM,F5N,0,0,2,0,2
967183,10/23 04:56 PM,F6N,1,0,0,0,1
967182,10/23 04:55 PM,F3XN,40,12,1,0,53
967181,10/23 04:55 PM,F6N,2,0,0,0,2
967180,10/23 04:55 PM,F3XN,7,1,0,0,8
967179,10/23 04:55 PM,F6N,4,0,0,0,4
967178,10/23 04:54 PM,F3XN,0,26,0,15,41
967177,10/23 04:54 PM,F6N,25,0,0,0,25
967176,10/23 04:53 PM,F3N,1528,178,0,40,1746
967175,10/23 04:52 PM,F3XN,1958,117,0,3,2078
967174,10/23 04:52 PM,F3XN,23,9,0,0,32
967173,10/23 04:52 PM,F24N,0,0,2,0,2
967172,10/23 04:52 PM,F3XN,100,3,0,0,103
967171,10/23 04:52 PM,F6N,7,0,0,0,7
967170,10/23 04:52 PM,F3XN,199,117,10,17,343
967169,10/23 04:51 PM,F3XN,0,0,0,1,1
967168,10/23 04:51 PM,F3N,10,15,0,0,25
967167,10/23 04:51 PM,F6N,1,0,0,0,1
967166,10/23 04:51 PM,F3XN,12,16,0,0,28
967165,10/23 04:50 PM,F3N,98,45,0,0,143
967164,10/23 04:50 PM,F6N,4,0,0,0,4
967163,10/23 04:50 PM,F6N,2,0,0,0,2
967162,10/23 04:50 PM,F24N,0,0,6,0,6
967161,10/23 04:50 PM,F3XN,0,2,0,2,4
967160,10/23 04:50 PM,F3XN,24,2,0,0,26
967159,10/23 04:49 PM,F6N,2,0,0,0,2
967158,10/23 04:49 PM,F3XN,231,22,0,0,253
967157,10/23 04:49 PM,F3XN,71,39,0,23,133
967156,10/23 04:49 PM,F99,0,0,0,0,0
967155,10/23 04:48 PM,F3XN,0,5,0,0,5
967154,10/23 04:47 PM,F6N,1,0,0,0,1
967153,10/23 04:47 PM,F3N,104,21,0,0,125
967152,10/23 04:47 PM,F3XN,0,1,0,0,1
967151,10/23 04:46 PM,F3XN,3,9,0,1,13
967150,10/23 04:46 PM,F3XN,7,0,0,0,7
967149,10/23 04:46 PM,F3N,24,100,0,0,124
967148,10/23 04:46 PM,F6N,31,0,0,0,31
967147,10/23 04:46 PM,F3XN,105,81,0,238,424
967146,10/23 04:46 PM,F3XN,43,1,0,0,44
967145,10/23 04:45 PM,F3N,69,39,0,0,108
967144,10/23 04:45 PM,F3N,28,77,0,6,111
967143,10/23 04:45 PM,F3XN,23,1,0,0,24
967142,10/23 04:45 PM,F3XA,75,42,0,0,117
967141,10/23 04:45 PM,F3N,9,2,0,0,11
967140,10/23 04:45 PM,F3XN,7,1,0,0,8
967139,10/23 04:44 PM,F3XN,98,102,0,0,200
967138,10/23 04:44 PM,F3XN,104,413,0,0,517
967137,10/23 04:44 PM,F3N,14,54,0,0,68
967136,10/23 04:43 PM,F3XN,8,32,0,0,40
967135,10/23 04:42 PM,F3XN,96,3,0,0,99
967134,10/23 04:42 PM,F3XN,2,1,0,0,3
967133,10/23 04:42 PM,F3XN,59,0,0,0,59
967132,10/23 04:42 PM,F3XN,1,13,0,2,16
967131,10/23 04:42 PM,F3XN,0,0,0,0,0
967130,10/23 04:41 PM,F6N,1,0,0,0,1
967129,10/23 04:41 PM,F3N,18,29,0,0,47
967128,10/23 04:41 PM,F3XN,0,0,0,4,4
967127,10/23 04:41 PM,F3XN,3,1,0,0,4
967126,10/23 04:41 PM,F3XN,1,31,0,0,32
967125,10/23 04:41 PM,F5N,0,0,2,0,2
967124,10/23 04:40 PM,F3XN,11,1,0,0,12
967123,10/23 04:40 PM,F3XN,0,0,0,0,0
967122,10/23 04:40 PM,F3XN,44,0,0,0,44
967121,10/23 04:40 PM,F3XN,226,0,0,0,226
967120,10/23 04:39 PM,F6N,9,0,0,0,9
967119,10/23 04:39 PM,F3N,4,38,0,0,42
967118,10/23 04:39 PM,F3N,192,94,0,0,286
967117,10/23 04:39 PM,F99,0,0,0,0,0
967116,10/23 04:39 PM,F6N,3,0,0,0,3
967115,10/23 04:39 PM,F3N,240,65,0,0,305
967114,10/23 04:39 PM,F3XN,1,0,0,0,1
967113,10/23 04:38 PM,F3N,6,1,0,6,13
967112,10/23 04:38 PM,F3N,47,19,0,0,66
967111,10/23 04:38 PM,F3N,97,27,0,2,126
967110,10/23 04:38 PM,F3XA,109,21,0,143,273
967109,10/23 04:38 PM,F3XN,0,0,0,0,0
967108,10/23 04:37 PM,F3N,52,58,0,0,110
967107,10/23 04:37 PM,F3XN,3,0,0,0,3
967106,10/23 04:37 PM,F3XN,261,0,0,0,261
967105,10/23 04:37 PM,F3N,79,40,0,0,119
967104,10/23 04:35 PM,F3N,52,20,0,4,76
967103,10/23 04:35 PM,F3N,66,55,0,7,128
967102,10/23 04:35 PM,F3N,1,19,0,0,20
967101,10/23 04:34 PM,F3XN,0,0,0,0,0
967100,10/23 04:34 PM,F3N,3,4,0,3,10
967099,10/23 04:34 PM,F3N,169,53,0,7,229
967098,10/23 04:33 PM,F3XN,0,1,0,0,1
967097,10/23 04:33 PM,F3XN,64,1,0,0,65
967096,10/23 04:33 PM,F3XN,0,2,0,0,2
967095,10/23 04:33 PM,F3XN,0,0,0,1,1
967094,10/23 04:31 PM,F5N,0,0,3,0,3
967093,10/23 04:30 PM,F3N,102,73,0,11,186
967092,10/23 04:30 PM,F6N,1,0,0,0,1
967091,10/23 04:30 PM,F6N,1,0,0,0,1
967090,10/23 04:30 PM,F3XN,206,1,0,0,207
967089,10/23 04:29 PM,F3XN,0,0,0,0,0
967088,10/23 04:29 PM,F3N,0,0,0,0,0
967087,10/23 04:29 PM,F3N,22,15,0,0,37
967086,10/23 04:29 PM,F3N,1,18,0,0,19
967085,10/23 04:29 PM,F3N,9,62,0,0,71
967084,10/23 04:29 PM,F3T,0,1,0,0,1
967083,10/23 04:29 PM,F6N,1,0,0,0,1
967082,10/23 04:28 PM,F3XN,7,0,2,1,10
967081,10/23 04:28 PM,F3N,674,83,0,0,757
967080,10/23 04:28 PM,F3XN,99,98,0,212,409
967079,10/23 04:28 PM,F3N,14,12,0,7,33
967078,10/23 04:27 PM,F3XN,0,0,0,0,0
967077,10/23 04:27 PM,F3XN,9,0,0,0,9
967076,10/23 04:26 PM,F3XN,179,9,0,0,188
967075,10/23 04:26 PM,F3N,37,51,0,0,88
967074,10/23 04:26 PM,F3N,44,45,0,6,95
967073,10/23 04:25 PM,F3N,13,19,0,0,32
967072,10/23 04:25 PM,F3XN,1,4,0,0,5
967071,10/23 04:25 PM,F3XN,0,4,0,0,4
967070,10/23 04:25 PM,F3XN,1675,82,0,0,1757
967069,10/23 04:25 PM,F3XN,15,13,0,2,30
967068,10/23 04:24 PM,F3XN,220,37,6,23,286
967067,10/23 04:24 PM,F3XN,12,46,40,14,112
967066,10/23 04:24 PM,F3XN,2,15,0,0,17
967065,10/23 04:24 PM,F3XN,1,0,0,0,1
967064,10/23 04:23 PM,F3N,72,62,0,0,134
967063,10/23 04:23 PM,F3XN,2,10,0,0,12
967062,10/23 04:21 PM,F3XN,252,19,0,0,271
967061,10/23 04:21 PM,F3XN,0,4,0,0,4
967060,10/23 04:21 PM,F6N,3,0,0,0,3
967059,10/23 04:21 PM,F3N,24,43,0,5,72
967058,10/23 04:21 PM,F3XN,72,71,36,20,199
967057,10/23 04:20 PM,F3N,35,36,0,1,72
967056,10/23 04:20 PM,F3N,34,36,0,0,70
967055,10/23 04:19 PM,F3XN,34,6,0,0,40
967054,10/23 04:19 PM,F6N,1,0,0,0,1
967053,10/23 04:19 PM,F3XN,0,0,0,1,1
967052,10/23 04:18 PM,F3XN,766,168,0,0,934
967051,10/23 04:18 PM,F3XN,87,349,0,2,438
967050,10/23 04:18 PM,F3XN,0,0,0,2,2
967049,10/23 04:18 PM,F3XN,0,0,0,0,0
967048,10/23 04:18 PM,F3N,5,8,0,21,34
967047,10/23 04:17 PM,F3XN,2,21,0,0,23
967046,10/23 04:16 PM,F3XN,136,3,0,0,139
967045,10/23 04:16 PM,F3N,81,78,0,3,162
967044,10/23 04:16 PM,F6N,4,0,0,0,4
967043,10/23 04:16 PM,F3N,16,15,0,0,31
967042,10/23 04:15 PM,F3N,17,37,0,0,54
967041,10/23 04:15 PM,F3N,16,20,0,0,36
967040,10/23 04:15 PM,F3XA,74,17,0,72,163
967039,10/23 04:14 PM,F3XN,13,57,12,0,82
967038,10/23 04:14 PM,F6N,2,0,0,0,2
967037,10/23 04:14 PM,F3XN,0,0,0,0,0
967036,10/23 04:14 PM,F3XN,9,2,0,0,11
967035,10/23 04:13 PM,F6N,3,0,0,0,3
967034,10/23 04:13 PM,F24N,0,0,1,0,1
967033,10/23 04:13 PM,F6N,6,0,0,0,6
967032,10/23 04:13 PM,F3XN,0,1,0,0,1
967031,10/23 04:12 PM,F3XN,9,3,0,35,47
967030,10/23 04:11 PM,F6N,3,0,0,0,3
967029,10/23 04:11 PM,F99,0,0,0,0,0
967028,10/23 04:11 PM,F3XN,11,10,0,0,21
967027,10/23 04:11 PM,F3N,24,9,0,0,33
967026,10/23 04:11 PM,F3XN,0,0,0,0,0
967025,10/23 04:10 PM,F6N,3,0,0,0,3
967024,10/23 04:10 PM,F3XN,0,1,0,0,1
967023,10/23 04:10 PM,F3XN,0,0,0,0,0
967022,10/23 04:10 PM,F3XN,0,0,0,0,0
967021,10/23 04:09 PM,F3N,64,38,0,1,103
967020,10/23 04:09 PM,F6N,8,0,0,0,8
967019,10/23 04:09 PM,F3XN,1,3,0,0,4
967018,10/23 04:09 PM,F3XN,1,18,0,0,19
967017,10/23 04:08 PM,F3XN,36,0,0,0,36
967016,10/23 04:08 PM,F3XN,4,0,0,0,4
967015,10/23 04:08 PM,F3XT,0,0,0,0,0
967014,10/23 04:08 PM,F3XN,33,14,0,0,47
967013,10/23 04:08 PM,F3XN,2,2,0,0,4
967012,10/23 04:08 PM,F3XN,10,16,22,1,49
967011,10/23 04:07 PM,F3XN,275,56,0,0,331
967010,10/23 04:07 PM,F3XN,1,1,0,8,10
967009,10/23 04:07 PM,F3N,46,5,0,0,51
967008,10/23 04:06 PM,F3XN,28,1,0,0,29
967007,10/23 04:06 PM,F3XN,0,3,0,0,3
967006,10/23 04:05 PM,F3N,7,11,0,0,18
967005,10/23 04:05 PM,F3A,110,90,0,1,201
967004,10/23 04:05 PM,F3XN,0,0,0,0,0
967003,10/23 04:05 PM,F3XN,537,73,0,0,610
967002,10/23 04:05 PM,F3XN,1,1,0,0,2
967001,10/23 04:04 PM,F6N,2,0,0,0,2
967000,10/23 04:04 PM,F3XN,10,3,0,0,13
966999,10/23 04:04 PM,F3XN,0,1,0,2,3
966998,10/23 04:04 PM,F3N,13,6,0,2,21
966997,10/23 04:03 PM,F3XN,187,3,0,0,190
966996,10/23 04:03 PM,F3XN,3,1,0,0,4
966995,10/23 04:03 PM,F3XN,0,0,0,0,0
966994,10/23 04:03 PM,F3N,27,14,0,0,41
966993,10/23 04:02 PM,F3XN,0,7,0,0,7
966992,10/23 04:02 PM,F3N,108,46,0,0,154
966991,10/23 04:02 PM,F3XN,0,7,0,0,7
966990,10/23 04:02 PM,F3XN,2,3,0,0,5
966989,10/23 04:02 PM,F3A,670,113,0,7,790
966988,10/23 04:02 PM,F3XN,0,0,0,0,0
966987,10/23 04:02 PM,F3XN,5,5,0,0,10
966986,10/23 04:01 PM,F3N,0,11,0,0,11
966985,10/23 04:01 PM,F3XN,0,2,0,0,2
966984,10/23 04:01 PM,F3XN,1131,972,20,0,2123
966983,10/23 04:01 PM,F3XN,3,3,0,0,6
966982,10/23 04:01 PM,F3XN,0,0,0,1,1
966981,10/23 04:00 PM,F6N,2,0,0,0,2
966980,10/23 04:00 PM,F3XN,41,1,0,0,42
966979,10/23 04:00 PM,F3XN,57,152,0,0,209
966978,10/23 04:00 PM,F3XN,4,0,0,0,4
966977,10/23 04:00 PM,F3N,21,69,0,5,95
966976,10/23 04:00 PM,F3N,89,51,0,1,141
966975,10/23 04:00 PM,F3XN,0,1,0,0,1
966974,10/23 04:00 PM,F3N,6,5,0,1,12
966973,10/23 04:00 PM,F3N,40,14,0,3,57
966972,10/23 03:59 PM,F3XN,1,11,0,0,12
966971,10/23 03:59 PM,F99,0,0,0,0,0
966970,10/23 03:58 PM,F3XN,0,1,0,0,1
966969,10/23 03:58 PM,F3XN,73,0,0,0,73
966968,10/23 03:58 PM,F3XN,13,0,0,0,13
966967,10/23 03:58 PM,F3XN,2,14,0,0,16
966965,10/23 03:57 PM,F3XN,3,0,0,0,3
966964,10/23 03:57 PM,F3XN,0,1,0,0,1
966962,10/23 03:57 PM,F3N,5,6,0,0,11
966960,10/23 03:57 PM,F6N,2,0,0,0,2
966958,10/23 03:56 PM,F3XN,21,6,0,0,27
966956,10/23 03:56 PM,F5N,0,0,2,0,2
966952,10/23 03:56 PM,F3XN,0,1,0,0,1
966951,10/23 03:55 PM,F3XN,0,1,0,0,1
966950,10/23 03:55 PM,F3XN,18,3,0,0,21
966949,10/23 03:55 PM,F3XA,7,0,0,0,7
966946,10/23 03:55 PM,F6N,5,0,0,0,5
966945,10/23 03:54 PM,F6N,4,0,0,0,4
966943,10/23 03:54 PM,F3XN,3,0,0,0,3
966940,10/23 03:54 PM,F3XN,0,3,0,0,3
966937,10/23 03:53 PM,F1N,0,0,0,0,0
966936,10/23 03:53 PM,F3XN,1,8,0,0,9
966935,10/23 03:53 PM,F3N,4,4,0,0,8
966934,10/23 03:53 PM,F3XN,0,3,0,0,3
966932,10/23 03:53 PM,F24N,0,0,11,0,11
966931,10/23 03:53 PM,F3XN,52,5,0,0,57
966929,10/23 03:53 PM,F3XN,54,95,0,14,163
966928,10/23 03:53 PM,F3N,1383,86,0,0,1469
966927,10/23 03:52 PM,F3N,112,46,0,0,158
966925,10/23 03:52 PM,F3XN,5,8,0,0,13
966924,10/23 03:52 PM,F3XN,9,0,0,0,9
966923,10/23 03:52 PM,F3XN,1,16,0,0,17
966922,10/23 03:52 PM,F3N,99,110,0,8,217
966921,10/23 03:51 PM,F3N,29,22,0,2,53
966920,10/23 03:51 PM,F3XN,21,0,0,0,21
966919,10/23 03:51 PM,F3XN,0,2,0,0,2
966918,10/23 03:51 PM,F3N,14,3,0,0,17
966917,10/23 03:50 PM,F3XN,25,4,0,0,29
966916,10/23 03:50 PM,F3N,4,22,0,0,26
966915,10/23 03:50 PM,F3XN,17,3,0,3,23
966914,10/23 03:50 PM,F6N,1,0,0,0,1
966913,10/23 03:49 PM,F3N,31,88,0,0,119
966912,10/23 03:49 PM,F3XN,0,0,0,0,0
966911,10/23 03:49 PM,F3N,6,9,0,14,29
966910,10/23 03:49 PM,F3XN,7,1,0,0,8
966909,10/23 03:49 PM,F3XN,17,24,0,0,41
966908,10/23 03:48 PM,F6N,1,0,0,0,1
966907,10/23 03:47 PM,F3N,1356,85,0,0,1441
966906,10/23 03:47 PM,F3XN,5,1,0,0,6
966905,10/23 03:47 PM,F3XN,0,1,0,0,1
966904,10/23 03:47 PM,F3N,0,0,0,2,2
966903,10/23 03:47 PM,F3XN,3,1,0,0,4
966902,10/23 03:46 PM,F24N,0,0,1,0,1
966901,10/23 03:46 PM,F3N,52,31,0,7,90
966900,10/23 03:46 PM,F1A,0,0,0,0,0
966899,10/23 03:46 PM,F3XN,0,1,0,0,1
966898,10/23 03:45 PM,F3N,13,19,0,0,32
966897,10/23 03:45 PM,F3N,19,34,0,0,53
966896,10/23 03:45 PM,F3XN,0,1,0,0,1
966895,10/23 03:45 PM,F3XA,142,3,0,1,146
966894,10/23 03:45 PM,F3XN,1,43,0,0,44
966893,10/23 03:45 PM,F6N,2,0,0,0,2
966892,10/23 03:44 PM,F3XN,0,0,0,0,0
966891,10/23 03:44 PM,F6N,1,0,0,0,1
966890,10/23 03:44 PM,F3N,98,18,0,0,116
966889,10/23 03:44 PM,F6N,3,0,0,0,3
966888,10/23 03:44 PM,F3XN,18,18,0,0,36
966887,10/23 03:43 PM,F3XN,0,0,0,1,1
966886,10/23 03:43 PM,F3XN,131,4,0,0,135
966885,10/23 03:43 PM,F3N,74,28,0,0,102
966884,10/23 03:41 PM,F3N,15,9,0,15,39
966883,10/23 03:41 PM,F3N,25,18,0,8,51
966882,10/23 03:40 PM,F3N,16,28,0,9,53
966881,10/23 03:39 PM,F3XN,0,1,0,0,1
966880,10/23 03:38 PM,F3XN,40,0,0,0,40
966879,10/23 03:38 PM,F3XN,0,7,0,0,7
966878,10/23 03:38 PM,F3XA,219,109,0,0,328
966877,10/23 03:38 PM,F3XN,39,1,0,0,40
966876,10/23 03:37 PM,F3XN,0,0,0,0,0
966875,10/23 03:37 PM,F3N,12,18,0,0,30
966874,10/23 03:35 PM,F3XN,0,0,0,0,0
966873,10/23 03:35 PM,F1A,0,0,0,0,0
966872,10/23 03:35 PM,F3N,5,3,0,0,8
966871,10/23 03:34 PM,F3XN,44,4,0,0,48
966870,10/23 03:34 PM,F3XA,173,26,0,0,199
966869,10/23 03:34 PM,F3XN,0,0,0,0,0
966868,10/23 03:34 PM,F3XN,4,17,0,0,21
966867,10/23 03:33 PM,F24N,0,0,3,0,3
966866,10/23 03:33 PM,F3XN,10,5,0,0,15
966865,10/23 03:33 PM,F99,0,0,0,0,0
966864,10/23 03:32 PM,F3XN,2,7,0,0,9
966863,10/23 03:32 PM,F3XA,129,6,0,0,135
966862,10/23 03:31 PM,F3N,41,58,0,3,102
966861,10/23 03:31 PM,F3XN,9,0,0,0,9
966860,10/23 03:31 PM,F3XN,0,7,0,0,7
966859,10/23 03:30 PM,F6N,3,0,0,0,3
966858,10/23 03:30 PM,F3XN,1,3,0,1,5
966857,10/23 03:29 PM,F3XN,167,7,0,0,174
966856,10/23 03:29 PM,F3N,28,17,0,0,45
966855,10/23 03:29 PM,F3XA,101,78,0,1,180
966854,10/23 03:28 PM,F3XN,0,38,0,0,38
966853,10/23 03:28 PM,F3XN,1,0,0,0,1
966852,10/23 03:28 PM,F3XN,0,0,0,0,0
966851,10/23 03:27 PM,F3XN,0,4,0,0,4
966850,10/23 03:27 PM,F6N,3,0,0,0,3
966849,10/23 03:27 PM,F3N,5,3,0,0,8
966848,10/23 03:26 PM,F24A,0,0,3,0,3
966847,10/23 03:26 PM,F3XN,12,18,0,126,156
966846,10/23 03:26 PM,F3XN,138,8,0,0,146
966845,10/23 03:26 PM,F3XN,0,0,0,0,0
966844,10/23 03:26 PM,F3XN,0,0,0,0,0
966843,10/23 03:25 PM,F3XN,9,0,0,0,9
966842,10/23 03:25 PM,F3N,8,8,0,1,17
966841,10/23 03:25 PM,F3XN,0,1,0,0,1
966840,10/23 03:25 PM,F3N,0,1,0,0,1
966839,10/23 03:25 PM,F3N,87,26,0,5,118
966838,10/23 03:25 PM,F3XN,20,1,0,0,21
966837,10/23 03:24 PM,F3XN,41,2,0,0,43
966836,10/23 03:24 PM,F3XN,93,1,0,0,94
966835,10/23 03:24 PM,F6N,12,0,0,0,12
966834,10/23 03:23 PM,F5N,0,0,2,0,2
966833,10/23 03:23 PM,F3N,3,1,0,0,4
966832,10/23 03:23 PM,F3N,62,25,0,4,91
966831,10/23 03:23 PM,F3XN,61,4,0,0,65
966830,10/23 03:23 PM,F6N,1,0,0,0,1
966829,10/23 03:23 PM,F3XN,126,10,0,0,136
966828,10/23 03:23 PM,F6N,10,0,0,0,10
966827,10/23 03:23 PM,F3N,10,22,0,1,33
966826,10/23 03:22 PM,F6N,1,0,0,0,1
966825,10/23 03:22 PM,F6N,3,0,0,0,3
966824,10/23 03:21 PM,F3N,62,23,0,0,85
966823,10/23 03:21 PM,F3XN,88,4,0,0,92
966822,10/23 03:21 PM,F3XN,0,9,0,0,9
966821,10/23 03:20 PM,F3XN,1,3,0,2,6
966820,10/23 03:19 PM,F6N,3,0,0,0,3
966819,10/23 03:18 PM,F3XA,1,3,0,0,4
966818,10/23 03:17 PM,F3N,65,42,0,0,107
966817,10/23 03:17 PM,F3N,26,25,0,0,51
966816,10/23 03:17 PM,F3XN,0,1,0,0,1
966815,10/23 03:17 PM,F3XN,35,0,0,0,35
966814,10/23 03:16 PM,F6N,1,0,0,0,1
966813,10/23 03:16 PM,F3N,0,9,0,4,13
966812,10/23 03:16 PM,F3XN,30,0,0,0,30
966811,10/23 03:15 PM,F3XN,107,17,0,0,124
966810,10/23 03:15 PM,F3XN,0,0,0,0,0
966809,10/23 03:15 PM,F3N,168,57,0,7,232
966808,10/23 03:15 PM,F3XN,0,2,0,0,2
966807,10/23 03:15 PM,F3N,31,23,0,0,54
966806,10/23 03:14 PM,F3XN,13,4,0,0,17
966805,10/23 03:14 PM,F3N,40,33,0,15,88
966804,10/23 03:14 PM,F24N,0,0,4,0,4
966803,10/23 03:14 PM,F3XN,0,2,0,0,2
966802,10/23 03:13 PM,F3XN,7,1,0,0,8
966801,10/23 03:13 PM,F3XN,43,3,0,0,46
966800,10/23 03:13 PM,F3N,44,17,0,3,64
966799,10/23 03:12 PM,F3XN,23,1,0,0,24
966798,10/23 03:12 PM,F3XN,1400,13,0,1,1414
966797,10/23 03:12 PM,F3XN,23,0,0,0,23
966796,10/23 03:12 PM,F3XN,29,3,0,0,32
966795,10/23 03:11 PM,F3XN,0,27,0,0,27
966794,10/23 03:10 PM,F3XN,0,0,0,0,0
966793,10/23 03:10 PM,F3XN,29,32,0,0,61
966792,10/23 03:10 PM,F3XN,24,2,0,0,26
966791,10/23 03:09 PM,F3XN,98,17,0,0,115
966790,10/23 03:09 PM,F3N,91,33,0,0,124
966789,10/23 03:08 PM,F6N,13,0,0,0,13
966788,10/23 03:07 PM,F3XN,0,3,0,0,3
966787,10/23 03:07 PM,F3XN,11,15,0,0,26
966786,10/23 03:07 PM,F3N,94,29,0,1,124
966785,10/23 03:07 PM,F6N,6,0,0,0,6
966784,10/23 03:06 PM,F3N,10,39,0,3,52
966783,10/23 03:06 PM,F3XN,62,26,0,0,88
966782,10/23 03:06 PM,F3XN,2,2,0,4,8
966781,10/23 03:06 PM,F3XN,0,6,5,0,11
966780,10/23 03:06 PM,F3XN,2,23,8,33,66
966779,10/23 03:05 PM,F6N,2,0,0,0,2
966778,10/23 03:05 PM,F3XN,1,0,0,16,17
966777,10/23 03:05 PM,F3N,27,29,0,0,56
966776,10/23 03:05 PM,F3XN,5,3,0,1,9
966775,10/23 03:05 PM,F3XN,1,4,0,0,5
966774,10/23 03:05 PM,F3XN,21,0,0,0,21
966773,10/23 03:05 PM,F3XN,4,8,0,7,19
966772,10/23 03:05 PM,F3XN,1,3,0,0,4
966771,10/23 03:05 PM,F3XN,17,4,0,2,23
966770,10/23 03:04 PM,F3XN,5,8,0,3,16
966769,10/23 03:04 PM,F3XN,3,4,0,0,7
966768,10/23 03:04 PM,F3XN,10,5,0,15,30
966767,10/23 03:03 PM,F3XN,0,0,0,0,0
966766,10/23 03:03 PM,F3XN,102,5,0,1,108
966765,10/23 03:03 PM,F3XN,0,1,0,0,1
966764,10/23 03:02 PM,F3XN,0,4,0,0,4
966763,10/23 03:01 PM,F3XN,0,0,0,0,0
966762,10/23 03:01 PM,F3XN,0,0,0,2,2
966761,10/23 03:01 PM,F3XN,0,2,0,1,3
966760,10/23 03:00 PM,F3XN,1,1,0,0,2
966759,10/23 03:00 PM,F3N,77,23,0,10,110
966758,10/23 03:00 PM,F3XT,0,0,0,0,0
966757,10/23 03:00 PM,F6N,7,0,0,0,7
966756,10/23 03:00 PM,F3XN,0,1,0,0,1
966755,10/23 03:00 PM,F24N,0,0,4,0,4
966754,10/23 03:00 PM,F3XN,3,0,0,0,3
966753,10/23 03:00 PM,F3XN,722,64,0,0,786
966752,10/23 03:00 PM,F3XN,3,2,0,0,5
966751,10/23 02:59 PM,F3N,0,0,0,0,0
966750,10/23 02:59 PM,F3XN,3,4,0,0,7
966749,10/23 02:59 PM,F3N,727,71,0,0,798
966748,10/23 02:59 PM,F3XN,1,5,4,0,10
966747,10/23 02:59 PM,F3N,31,77,0,1,109
966746,10/23 02:58 PM,F3XN,2,4,0,0,6
966745,10/23 02:58 PM,F3XN,2,12,0,0,14
966744,10/23 02:58 PM,F3N,35,30,0,0,65
966743,10/23 02:58 PM,F6N,15,0,0,0,15
966742,10/23 02:58 PM,F3N,59,30,0,4,93
966741,10/23 02:57 PM,F6N,3,0,0,0,3
966740,10/23 02:57 PM,F6N,6,0,0,0,6
966739,10/23 02:57 PM,F3N,104,77,0,12,193
966738,10/23 02:56 PM,F3XN,505,23,0,0,528
966737,10/23 02:56 PM,F3N,79,46,0,5,130
966736,10/23 02:55 PM,F3XN,4,7,0,0,11
966735,10/23 02:55 PM,F6N,2,0,0,0,2
966734,10/23 02:54 PM,F3XN,0,0,0,0,0
966733,10/23 02:54 PM,F3XN,915,1,0,0,916
966732,10/23 02:54 PM,F3XN,39,13,0,106,158
966731,10/23 02:54 PM,F3XN,4,1,0,0,5
966730,10/23 02:54 PM,F6N,7,0,0,0,7
966729,10/23 02:54 PM,F3XN,4,0,0,0,4
966728,10/23 02:53 PM,F6N,1,0,0,0,1
966727,10/23 02:53 PM,F3XN,1,4,0,0,5
966726,10/23 02:52 PM,F6N,6,0,0,0,6
966725,10/23 02:52 PM,F3XN,0,1,0,0,1
966724,10/23 02:52 PM,F3N,64,85,0,0,149
966723,10/23 02:52 PM,F3XN,51,1,0,0,52
966722,10/23 02:52 PM,F3XN,3,6,0,0,9
966721,10/23 02:51 PM,F3XN,242,10,1,0,253
966720,10/23 02:51 PM,F3XA,1,6,0,1,8
966719,10/23 02:51 PM,F3XN,0,1,0,0,1
966718,10/23 02:51 PM,F3N,5,5,0,0,10
966717,10/23 02:50 PM,F3XN,377,18,0,0,395
966716,10/23 02:50 PM,F3XN,4,2,0,0,6
966715,10/23 02:49 PM,F3XN,3,2,0,0,5
966714,10/23 02:48 PM,F3N,1,0,0,42,43
966713,10/23 02:48 PM,F3XN,0,6,0,0,6
966712,10/23 02:48 PM,F3N,20,15,0,1,36
966711,10/23 02:48 PM,F3XN,0,5,0,0,5
966710,10/23 02:47 PM,F3XN,1,4,0,0,5
966709,10/23 02:47 PM,F3XN,68,119,0,34,221
966708,10/23 02:47 PM,F6N,1,0,0,0,1
966707,10/23 02:47 PM,F3XN,0,0,0,0,0
966706,10/23 02:46 PM,F3XN,141,5,53,6,205
966705,10/23 02:46 PM,F3XN,117,9,0,0,126
966704,10/23 02:46 PM,F3N,27,36,0,2,65
966703,10/23 02:45 PM,F3XN,24,21,0,0,45
966702,10/23 02:45 PM,F3N,113,61,0,0,174
966701,10/23 02:45 PM,F3N,27,72,0,9,108
966700,10/23 02:45 PM,F3XN,21,9,0,0,30
966699,10/23 02:45 PM,F24N,0,0,2,0,2
966698,10/23 02:43 PM,F3XN,0,1,0,0,1
966697,10/23 02:43 PM,F3XN,85,0,0,0,85
966696,10/23 02:42 PM,F3XN,3,1,0,0,4
966695,10/23 02:42 PM,F3XN,0,0,0,0,0
966694,10/23 02:42 PM,F3XN,0,1,0,0,1
966693,10/23 02:42 PM,F3XN,6,6,0,0,12
966692,10/23 02:42 PM,F3N,111,51,0,0,162
966691,10/23 02:42 PM,F3XA,0,5,0,0,5
966690,10/23 02:41 PM,F3XN,0,0,0,0,0
966689,10/23 02:40 PM,F3XN,1781,96,0,93,1970
966688,10/23 02:39 PM,F3XN,0,1,0,0,1
966687,10/23 02:39 PM,F3XN,142,1,0,0,143
966686,10/23 02:39 PM,F3XN,8,7,0,0,15
966685,10/23 02:38 PM,F3N,23,9,0,1,33
966684,10/23 02:38 PM,F3XN,0,13,0,0,13
966683,10/23 02:37 PM,F3XN,12,2,0,57,71
966682,10/23 02:37 PM,F99,0,0,0,0,0
966681,10/23 02:36 PM,F3XN,901,75,0,0,976
966680,10/23 02:35 PM,F6N,2,0,0,0,2
966679,10/23 02:35 PM,F3XN,98,2,0,0,100
966678,10/23 02:35 PM,F3XN,0,0,0,0,0
966677,10/23 02:34 PM,F3XN,0,2,0,0,2
966676,10/23 02:34 PM,F3XN,135,13,0,0,148
966675,10/23 02:33 PM,F3XN,7,7,0,0,14
966674,10/23 02:33 PM,F3XN,5,0,0,0,5
966673,10/23 02:33 PM,F6N,1,0,0,0,1
966672,10/23 02:31 PM,F3XN,422,56,0,0,478
966671,10/23 02:30 PM,F3XN,60,22,0,0,82
966670,10/23 02:30 PM,F3XN,29,9,0,0,38
966669,10/23 02:30 PM,F3XN,1,4,0,0,5
966668,10/23 02:29 PM,F3XA,0,5,0,0,5
966667,10/23 02:28 PM,F6N,3,0,0,0,3
966666,10/23 02:28 PM,F3N,45,54,0,2,101
966665,10/23 02:28 PM,F3XN,776,44,0,0,820
966664,10/23 02:28 PM,F3XN,12,4,0,0,16
966663,10/23 02:28 PM,F3XN,9,4,0,0,13
966662,10/23 02:28 PM,F3A,0,1,0,0,1
966661,10/23 02:27 PM,F3XN,1,6,0,0,7
966660,10/23 02:27 PM,F6N,4,0,0,0,4
966659,10/23 02:26 PM,F3A,0,0,0,0,0
966658,10/23 02:26 PM,F6N,2,0,0,0,2
966657,10/23 02:26 PM,F6N,1,0,0,0,1
966656,10/23 02:25 PM,F3XN,66,2,0,0,68
966655,10/23 02:25 PM,F3N,148,71,0,0,219
966654,10/23 02:25 PM,F3N,16,32,0,1,49
966653,10/23 02:25 PM,F3A,1,6,0,0,7
966652,10/23 02:24 PM,F3XN,2,3,9,0,14
966651,10/23 02:24 PM,F3XN,1,3,8,8,20
966650,10/23 02:24 PM,F6N,7,0,0,0,7
966649,10/23 02:24 PM,F3XN,829,67,17,0,913
966648,10/23 02:23 PM,F3XN,7,14,0,0,21
966647,10/23 02:23 PM,F6N,21,0,0,0,21
966646,10/23 02:22 PM,F3XN,0,2,0,0,2
966645,10/23 02:22 PM,F3N,1,2,0,0,3
966644,10/23 02:22 PM,F3XN,69,2,0,0,71
966643,10/23 02:21 PM,F3XN,8,7,9,1,25
966642,10/23 02:21 PM,F3N,33,90,0,0,123
966641,10/23 02:20 PM,F3N,3,4,0,0,7
966640,10/23 02:20 PM,F3N,224,63,0,0,287
966639,10/23 02:20 PM,F3XN,613,8,0,0,621
966638,10/23 02:18 PM,F3XN,4,0,0,0,4
966637,10/23 02:18 PM,F3N,15,24,0,0,39
966636,10/23 02:18 PM,F3N,12,33,0,2,47
966635,10/23 02:18 PM,F3N,39,21,0,6,66
966634,10/23 02:18 PM,F3N,265,90,0,0,355
966633,10/23 02:17 PM,F3XN,104,5,0,0,109
966632,10/23 02:17 PM,F3N,34,36,0,2,72
966631,10/23 02:17 PM,F3XN,0,1,0,0,1
966630,10/23 02:16 PM,F3XN,0,0,0,0,0
966629,10/23 02:16 PM,F3XN,80,15,49,50,194
966628,10/23 02:16 PM,F3XN,0,0,0,0,0
966627,10/23 02:16 PM,F3N,38,27,0,0,65
966626,10/23 02:15 PM,F3XN,0,0,0,0,0
966625,10/23 02:15 PM,F3XN,1,0,0,0,1
966624,10/23 02:15 PM,F3XN,0,1,0,0,1
966623,10/23 02:15 PM,F3XN,9,4,0,0,13
966622,10/23 02:14 PM,F3XN,0,9,0,0,9
966621,10/23 02:14 PM,F3N,39,22,0,4,65
966620,10/23 02:14 PM,F3N,29,13,0,3,45
966619,10/23 02:13 PM,F3XN,1,1,0,0,2
966618,10/23 02:13 PM,F3XN,8,12,0,0,20
966617,10/23 02:13 PM,F3XN,3,31,0,0,34
966616,10/23 02:13 PM,F24N,0,0,5,1,6
966615,10/23 02:12 PM,F3XN,0,0,0,0,0
966614,10/23 02:12 PM,F6N,7,0,0,0,7
966613,10/23 02:12 PM,F3XN,28,3,0,0,31
966612,10/23 02:11 PM,F3XN,0,1,0,0,1
966611,10/23 02:11 PM,F6N,2,0,0,0,2
966610,10/23 02:11 PM,F99,0,0,0,0,0
966609,10/23 02:10 PM,F3N,11,18,0,1,30
966608,10/23 02:10 PM,F3N,18,96,0,18,132
966607,10/23 02:10 PM,F6N,1,0,0,0,1
966606,10/23 02:09 PM,F3N,0,0,0,0,0
966605,10/23 02:09 PM,F3N,21,19,0,2,42
966604,10/23 02:09 PM,F3XN,21,1,0,0,22
966603,10/23 02:09 PM,F3XN,0,3,0,0,3
966602,10/23 02:08 PM,F3N,42,41,0,0,83
966601,10/23 02:08 PM,F3XN,14,23,0,0,37
966600,10/23 02:07 PM,F3N,92,41,0,1,134
966599,10/23 02:07 PM,F3N,2,0,0,0,2
966598,10/23 02:06 PM,F3XN,1,1,0,0,2
966597,10/23 02:06 PM,F3N,204,45,0,6,255
966596,10/23 02:06 PM,F3XN,2,1,0,0,3
966595,10/23 02:05 PM,F3XN,2,4,0,0,6
966594,10/23 02:05 PM,F3T,0,0,0,0,0
966593,10/23 02:05 PM,F3XN,101,42,0,195,338
966592,10/23 02:05 PM,F3XN,54,48,0,24,126
966591,10/23 02:05 PM,F3XN,1,0,0,0,1
966590,10/23 02:05 PM,F3XN,0,0,0,0,0
966589,10/23 02:03 PM,F3XN,0,3,0,0,3
966588,10/23 02:03 PM,F3XN,6,0,0,47,53
966587,10/23 02:03 PM,F3A,62,62,0,4,128
966586,10/23 02:03 PM,F3XN,11,14,0,0,25
966585,10/23 02:02 PM,F99,0,0,0,0,0
966584,10/23 02:02 PM,F3XN,212,14,0,0,226
966583,10/23 02:02 PM,F3N,152,33,0,0,185
966582,10/23 02:02 PM,F3N,5,13,0,0,18
966581,10/23 02:01 PM,F3XN,193,0,0,1,194
966580,10/23 02:00 PM,F6N,3,0,0,0,3
966578,10/23 02:00 PM,F3T,0,0,0,0,0
966577,10/23 02:00 PM,F3XN,0,0,0,0,0
966576,10/23 02:00 PM,F24A,0,0,1,0,1
966574,10/23 01:59 PM,F3XN,4,0,0,0,4
966573,10/23 01:59 PM,F3XN,0,0,0,2,2
966567,10/23 01:58 PM,F3N,43,37,0,13,93
966566,10/23 01:58 PM,F3XN,0,0,0,0,0
966564,10/23 01:58 PM,F3XN,633,34,0,0,667
966563,10/23 01:58 PM,F3XN,1,2,0,0,3
966561,10/23 01:58 PM,F6N,1,0,0,0,1
966560,10/23 01:58 PM,F3XN,0,0,0,0,0
966558,10/23 01:57 PM,F3XN,2,8,0,0,10
966557,10/23 01:57 PM,F3XN,21,5,0,0,26
966556,10/23 01:57 PM,F3N,0,1,0,0,1
966555,10/23 01:56 PM,F3N,25,24,0,1,50
966554,10/23 01:56 PM,F3XN,0,0,0,0,0
966553,10/23 01:56 PM,F3N,63,10,0,0,73
966552,10/23 01:56 PM,F6N,7,0,0,0,7
966551,10/23 01:56 PM,F3N,31,58,0,0,89
966550,10/23 01:56 PM,F3XN,1481,113,0,0,1594
966549,10/23 01:55 PM,F3XN,2,2,0,0,4
966548,10/23 01:55 PM,F3XN,98,3,0,99,200
966547,10/23 01:54 PM,F3XN,0,1,0,0,1
966546,10/23 01:54 PM,F3XN,0,0,0,0,0
966545,10/23 01:54 PM,F6N,3,0,0,0,3
966544,10/23 01:54 PM,F99,0,0,0,0,0
966543,10/23 01:53 PM,F3XN,0,0,0,0,0
966542,10/23 01:53 PM,F3XN,0,1,0,0,1
966541,10/23 01:52 PM,F6N,5,0,0,0,5
966540,10/23 01:52 PM,F3XN,0,0,0,0,0
966539,10/23 01:52 PM,F3XN,0,0,0,0,0
966538,10/23 01:51 PM,F3XN,0,0,0,0,0
966537,10/23 01:51 PM,F3N,0,0,0,0,0
966536,10/23 01:51 PM,F3XN,747,0,0,0,747
966535,10/23 01:51 PM,F3XN,0,2,0,0,2
966534,10/23 01:51 PM,F3N,2,21,0,0,23
966533,10/23 01:51 PM,F3XN,5,6,0,0,11
966532,10/23 01:50 PM,F3XN,28,0,0,0,28
966531,10/23 01:49 PM,F3XN,2,4,0,0,6
966530,10/23 01:48 PM,F6N,3,0,0,0,3
966529,10/23 01:48 PM,F3XN,882,829,0,0,1711
966528,10/23 01:48 PM,F3XN,0,1,0,0,1
966527,10/23 01:47 PM,F6N,2,0,0,0,2
966526,10/23 01:47 PM,F3XN,111,14,0,0,125
966525,10/23 01:46 PM,F3XN,3,4,0,0,7
966524,10/23 01:46 PM,F3XN,26,5,0,0,31
966523,10/23 01:46 PM,F3XN,23,227,0,0,250
966522,10/23 01:46 PM,F6N,1,0,0,0,1
966521,10/23 01:46 PM,F3XN,1,1,0,0,2
966520,10/23 01:46 PM,F3XN,2,12,0,0,14
966519,10/23 01:46 PM,F3XN,3,4,6,6,19
966518,10/23 01:45 PM,F3XN,0,1,0,0,1
966517,10/23 01:44 PM,F3XN,205,272,0,125,602
966516,10/23 01:44 PM,F3N,7,4,0,2,13
966515,10/23 01:43 PM,F3XN,3,2,0,0,5
966514,10/23 01:43 PM,F3XN,0,0,0,0,0
966513,10/23 01:43 PM,F3XN,3,5,0,0,8
966512,10/23 01:42 PM,F6N,1,0,0,0,1
966511,10/23 01:42 PM,F6N,6,0,0,0,6
966510,10/23 01:41 PM,F1A,0,0,0,0,0
966509,10/23 01:40 PM,F3XN,2,0,0,0,2
966508,10/23 01:40 PM,F3N,0,0,0,0,0
966507,10/23 01:39 PM,F3N,85,15,0,0,100
966506,10/23 01:39 PM,F3XN,0,3,0,0,3
966505,10/23 01:39 PM,F6N,2,0,0,0,2
966504,10/23 01:39 PM,F3N,2,27,0,7,36
966503,10/23 01:39 PM,F3XN,252,8,0,0,260
966502,10/23 01:39 PM,F6N,2,0,0,0,2
966501,10/23 01:39 PM,F3N,10,17,0,0,27
966500,10/23 01:38 PM,F3XN,4,4,0,0,8
966499,10/23 01:38 PM,F3XN,0,0,0,0,0
966498,10/23 01:38 PM,F3XN,7,7,0,0,14
966497,10/23 01:38 PM,F3N,0,0,0,0,0
966496,10/23 01:37 PM,F3XN,32,1,0,0,33
966495,10/23 01:36 PM,F3XN,143,11,0,0,154
966494,10/23 01:36 PM,F3XN,54,52,34,1,141
966493,10/23 01:36 PM,F3XN,380,13,60,0,453
966492,10/23 01:35 PM,F3XN,24,115,0,0,139
966491,10/23 01:34 PM,F3XN,15,36,0,0,51
966490,10/23 01:34 PM,F3N,31,16,0,0,47
966489,10/23 01:33 PM,F3XN,0,0,0,0,0
966488,10/23 01:33 PM,F3XN,5,11,0,0,16
966487,10/23 01:31 PM,F6N,1,0,0,0,1
966486,10/23 01:30 PM,F3N,82,51,0,0,133
966485,10/23 01:30 PM,F3XN,57,2,0,0,59
966484,10/23 01:30 PM,F3XN,524,33,10,0,567
966483,10/23 01:30 PM,F3XN,18,12,2,1,33
966482,10/23 01:30 PM,F3XN,0,0,0,0,0
966481,10/23 01:30 PM,F6N,4,0,0,0,4
966480,10/23 01:29 PM,F3XN,0,2,0,0,2
966479,10/23 01:29 PM,F3N,108,13,0,1,122
966478,10/23 01:28 PM,F3XN,253,0,0,0,253
966477,10/23 01:28 PM,F3N,5,14,0,0,19
966476,10/23 01:28 PM,F3XA,116,69,0,0,185
966475,10/23 01:28 PM,F6N,2,0,0,0,2
966474,10/23 01:27 PM,F3XN,0,0,0,0,0
966473,10/23 01:27 PM,F3XN,0,0,0,0,0
966472,10/23 01:26 PM,F3XN,0,8,0,0,8
966471,10/23 01:25 PM,F3XN,2,1,0,0,3
966470,10/23 01:24 PM,F3N,42,28,0,0,70
966469,10/23 01:24 PM,F3XN,14,0,0,0,14
966468,10/23 01:24 PM,F3XN,64,16,0,0,80
966467,10/23 01:24 PM,F1N,0,0,0,0,0
966466,10/23 01:24 PM,F3XN,201,0,0,0,201
966465,10/23 01:23 PM,F3XN,0,0,0,0,0
966464,10/23 01:23 PM,F3XN,0,0,0,0,0
966463,10/23 01:23 PM,F6N,2,0,0,0,2
966462,10/23 01:23 PM,F3N,11,40,0,8,59
966461,10/23 01:23 PM,F3XN,1,13,0,0,14
966460,10/23 01:23 PM,F3XN,0,1,0,0,1
966459,10/23 01:22 PM,F3XN,0,1,0,0,1
966458,10/23 01:22 PM,F3XN,1,2,1,0,4
966457,10/23 01:21 PM,F3XN,0,0,0,0,0
966456,10/23 01:21 PM,F3XN,0,0,0,0,0
966455,10/23 01:20 PM,F24N,0,0,3,0,3
966454,10/23 01:20 PM,F3N,37,8,0,0,45
966453,10/23 01:20 PM,F3XN,0,0,0,0,0
966452,10/23 01:20 PM,F3N,87,54,0,8,149
966451,10/23 01:20 PM,F3XN,0,0,0,0,0
966450,10/23 01:19 PM,F3XN,0,0,0,0,0
966449,10/23 01:19 PM,F3XN,0,0,0,0,0
966448,10/23 01:18 PM,F3XN,234,48,8,0,290
966447,10/23 01:18 PM,F3XN,57,8,0,0,65
966446,10/23 01:18 PM,F3XN,80,4,0,0,84
966445,10/23 01:17 PM,F3XN,417,107,0,65,589
966444,10/23 01:17 PM,F3N,45,42,0,0,87
966443,10/23 01:16 PM,F9N,0,0,0,4,4
966442,10/23 01:16 PM,F3N,60,41,0,0,101
966441,10/23 01:16 PM,F3N,176,69,0,0,245
966440,10/23 01:16 PM,F3XN,0,0,0,0,0
966439,10/23 01:16 PM,F3XN,0,0,0,0,0
966438,10/23 01:16 PM,F6N,2,0,0,0,2
966437,10/23 01:16 PM,F3N,0,3,0,2,5
966436,10/23 01:15 PM,F3XN,8,11,0,0,19
966435,10/23 01:14 PM,F3XN,283,17,0,0,300
966434,10/23 01:14 PM,F3XN,0,0,0,0,0
966433,10/23 01:13 PM,F3XN,0,0,0,0,0
966432,10/23 01:12 PM,F3XN,0,3,0,0,3
966431,10/23 01:12 PM,F3N,135,21,0,0,156
966430,10/23 01:11 PM,F3XN,29,49,0,0,78
966429,10/23 01:11 PM,F3XN,87,2,0,0,89
966428,10/23 01:11 PM,F3XN,2,4,0,0,6
966427,10/23 01:11 PM,F3XN,0,2,0,0,2
966426,10/23 01:11 PM,F3N,21,13,0,16,50
966425,10/23 01:11 PM,F6N,2,0,0,0,2
966424,10/23 01:11 PM,F3XN,116,69,0,0,185
966423,10/23 01:10 PM,F3N,48,46,0,11,105
966422,10/23 01:10 PM,F3XN,0,0,0,0,0
966421,10/23 01:10 PM,F3N,0,0,0,0,0
966420,10/23 01:10 PM,F3N,6,20,0,12,38
966419,10/23 01:09 PM,F3XN,3,2,0,0,5
966418,10/23 01:09 PM,F3A,45,51,0,23,119
966417,10/23 01:08 PM,F3XN,0,0,0,0,0
966416,10/23 01:08 PM,F3XN,0,0,0,0,0
966415,10/23 01:08 PM,F3XN,43,4,0,0,47
966414,10/23 01:07 PM,F3XN,0,1,0,0,1
966413,10/23 01:07 PM,F3XN,0,0,0,0,0
966412,10/23 01:05 PM,F3XA,469,108,0,0,577
966411,10/23 01:04 PM,F3XN,5,9,0,0,14
966410,10/23 01:04 PM,F3XN,0,0,0,0,0
966409,10/23 01:03 PM,F3XN,0,0,0,0,0
966408,10/23 01:03 PM,F99,0,0,0,0,0
966407,10/23 01:03 PM,F3XN,9,16,0,1,26
966406,10/23 01:02 PM,F3N,11,24,0,0,35
966405,10/23 01:02 PM,F3N,119,64,0,0,183
966404,10/23 01:02 PM,F3XN,0,0,0,0,0
966403,10/23 01:02 PM,F3N,2,11,0,0,13
966402,10/23 01:02 PM,F3N,47,37,0,2,86
966401,10/23 01:02 PM,F6N,1,0,0,0,1
966400,10/23 01:01 PM,F3N,51,32,0,2,85
966399,10/23 01:01 PM,F3XN,17,1,0,0,18
966398,10/23 01:01 PM,F3XN,0,1,0,0,1
966397,10/23 01:00 PM,F3XN,92,39,0,0,131
966396,10/23 01:00 PM,F3XN,0,0,0,0,0
966395,10/23 01:00 PM,F3XN,1,5,0,0,6
966394,10/23 12:59 PM,F3XN,4,4,0,0,8
966393,10/23 12:59 PM,F3XN,0,0,0,0,0
966392,10/23 12:59 PM,F3XN,5,2,0,0,7
966391,10/23 12:58 PM,F3XN,0,1,0,0,1
966390,10/23 12:58 PM,F3XN,0,0,0,0,0
966389,10/23 12:58 PM,F3XN,35,26,0,0,61
966388,10/23 12:57 PM,F3XN,1,13,0,0,14
966387,10/23 12:57 PM,F6A,8,0,0,0,8
966386,10/23 12:57 PM,F3XN,0,0,0,0,0
966385,10/23 12:56 PM,F3N,230,50,0,3,283
966384,10/23 12:56 PM,F3XN,1,0,0,0,1
966383,10/23 12:56 PM,F6N,9,0,0,0,9
966382,10/23 12:56 PM,F3XN,1,1,0,0,2
966381,10/23 12:55 PM,F3XN,0,2,0,0,2
966380,10/23 12:55 PM,F3N,2,15,0,0,17
966379,10/23 12:55 PM,F3N,0,0,0,3,3
966378,10/23 12:54 PM,F3N,10,37,0,0,47
966377,10/23 12:54 PM,F3XN,3,3,1,0,7
966376,10/23 12:54 PM,F3XN,65,7,0,0,72
966375,10/23 12:54 PM,F3XN,2,7,0,1,10
966374,10/23 12:53 PM,F3XN,58,36,0,32,126
966373,10/23 12:53 PM,F3XN,27,17,1,87,132
966372,10/23 12:53 PM,F3XN,4,2,0,0,6
966371,10/23 12:53 PM,F3XN,149,20,0,0,169
966370,10/23 12:53 PM,F3N,0,1,0,2,3
966369,10/23 12:52 PM,F3XN,0,0,0,0,0
966368,10/23 12:52 PM,F3XN,2,0,0,0,2
966367,10/23 12:52 PM,F3N,41,29,0,7,77
966366,10/23 12:52 PM,F3XN,7,2,0,0,9
966365,10/23 12:51 PM,F3XN,0,0,0,0,0
966364,10/23 12:51 PM,F6N,1,0,0,0,1
966363,10/23 12:50 PM,F3XN,3,0,0,0,3
966362,10/23 12:49 PM,F3A,11,23,0,29,63
966361,10/23 12:49 PM,F3XN,14,27,0,0,41
966360,10/23 12:48 PM,F6N,6,0,0,0,6
966359,10/23 12:48 PM,F3N,24,6,0,0,30
966358,10/23 12:48 PM,F3XN,0,0,0,0,0
966357,10/23 12:47 PM,F3XN,8,1,0,0,9
966356,10/23 12:47 PM,F3XN,0,0,0,0,0
966355,10/23 12:47 PM,F6N,3,0,0,0,3
966354,10/23 12:46 PM,F3XN,5,3,0,0,8
966353,10/23 12:46 PM,F3N,32,30,0,4,66
966352,10/23 12:46 PM,F3XN,0,3,0,0,3
966351,10/23 12:45 PM,F6N,1,0,0,0,1
966350,10/23 12:45 PM,F3XN,118,56,0,2,176
966349,10/23 12:44 PM,F9N,0,0,0,4,4
966348,10/23 12:44 PM,F1A,0,0,0,0,0
966347,10/23 12:44 PM,F3XN,7,0,0,0,7
966346,10/23 12:43 PM,F3XN,176,3,0,0,179
966345,10/23 12:43 PM,F3XN,97,0,0,0,97
966344,10/23 12:43 PM,F3XN,350,1,0,0,351
966343,10/23 12:43 PM,F3XN,1,2,0,0,3
966342,10/23 12:42 PM,F3N,7,30,0,23,60
966341,10/23 12:42 PM,F3N,37,12,0,2,51
966340,10/23 12:42 PM,F3XN,0,1,0,0,1
966339,10/23 12:41 PM,F3XN,3,1,0,0,4
966338,10/23 12:41 PM,F3XN,7,10,0,0,17
966337,10/23 12:41 PM,F3XN,0,0,0,5,5
966336,10/23 12:40 PM,F3XN,1,3,0,0,4
966335,10/23 12:39 PM,F3XN,0,5,0,0,5
966334,10/23 12:38 PM,F3N,1,12,0,0,13
966333,10/23 12:38 PM,F3XN,51,2,0,0,53
966332,10/23 12:38 PM,F3N,53,44,0,1,98
966331,10/23 12:37 PM,F6A,4,0,0,0,4
966330,10/23 12:37 PM,F3N,12,37,0,0,49
966329,10/23 12:37 PM,F3XN,0,0,0,0,0
966328,10/23 12:37 PM,F3XN,11,0,0,0,11
966327,10/23 12:37 PM,F3XN,0,6,0,0,6
966326,10/23 12:36 PM,F3XN,0,0,0,0,0
966325,10/23 12:35 PM,F3XN,1,2,0,0,3
966324,10/23 12:35 PM,F3N,32,63,0,6,101
966323,10/23 12:35 PM,F3XN,0,9,0,0,9
966322,10/23 12:35 PM,F3N,20,83,0,0,103
966321,10/23 12:35 PM,F3XN,1201,246,0,18,1465
966320,10/23 12:34 PM,F3N,17,43,0,0,60
966319,10/23 12:34 PM,F3XA,817,69,0,543,1429
966318,10/23 12:34 PM,F3XN,7,6,0,0,13
966317,10/23 12:34 PM,F3XN,0,3,0,0,3
966316,10/23 12:33 PM,F3XN,131,3,0,0,134
966315,10/23 12:32 PM,F3N,0,0,0,0,0
966314,10/23 12:32 PM,F6N,11,0,0,0,11
966313,10/23 12:31 PM,F3XN,2,0,0,0,2
966312,10/23 12:30 PM,F3N,26,28,0,2,56
966311,10/23 12:30 PM,F3XN,28,68,0,0,96
966310,10/23 12:28 PM,F3XN,0,3,0,1,4
966309,10/23 12:28 PM,F3XN,1,0,0,0,1
966308,10/23 12:27 PM,F3XN,0,1,0,0,1
966307,10/23 12:27 PM,F3XN,1,1,0,0,2
966306,10/23 12:27 PM,F3XN,1,2,0,0,3
966305,10/23 12:27 PM,F3XN,0,1,0,0,1
966304,10/23 12:27 PM,F24N,0,0,1,0,1
966303,10/23 12:26 PM,F3XN,0,0,0,0,0
966302,10/23 12:26 PM,F3XN,1160,35,0,0,1195
966301,10/23 12:26 PM,F3XN,0,1,0,0,1
966300,10/23 12:26 PM,F3XN,16,23,0,0,39
966299,10/23 12:25 PM,F3XN,34,5,0,2,41
966298,10/23 12:25 PM,F3N,45,22,0,1,68
966297,10/23 12:24 PM,F3XN,67,2,0,0,69
966296,10/23 12:24 PM,F3XN,761,16,0,0,777
966295,10/23 12:24 PM,F3XN,0,0,0,0,0
966294,10/23 12:24 PM,F3XN,2,7,0,0,9
966293,10/23 12:24 PM,F3N,20,31,0,0,51
966292,10/23 12:22 PM,F3XN,0,2,0,0,2
966291,10/23 12:22 PM,F3N,8,14,0,1,23
966290,10/23 12:22 PM,F3XN,1,3,0,0,4
966289,10/23 12:22 PM,F3XN,0,1,0,0,1
966288,10/23 12:22 PM,F3XN,0,1,0,0,1
966287,10/23 12:21 PM,F3XN,13,5,0,0,18
966286,10/23 12:21 PM,F3XA,0,0,0,0,0
966285,10/23 12:20 PM,F3XN,0,2,0,0,2
966284,10/23 12:20 PM,F3XN,42,32,0,0,74
966283,10/23 12:19 PM,F3XN,9,3,0,0,12
966282,10/23 12:19 PM,F7N,0,0,0,78,78
966281,10/23 12:18 PM,F3XN,13,1,0,0,14
966280,10/23 12:18 PM,F3XN,5,0,0,20,25
966279,10/23 12:17 PM,F3XN,13,1,1,6,21
966278,10/23 12:17 PM,F3XN,0,0,0,0,0
966277,10/23 12:17 PM,F3XN,6,30,0,0,36
966276,10/23 12:17 PM,F3N,103,15,0,1,119
966275,10/23 12:16 PM,F3XN,0,3,0,0,3
966274,10/23 12:16 PM,F3XN,44,9,0,0,53
966273,10/23 12:16 PM,F3XN,44,59,2609,0,2712
966272,10/23 12:16 PM,F3XN,10,20,0,0,30
966271,10/23 12:15 PM,F3XN,6,28,0,0,34
966270,10/23 12:15 PM,F3XN,0,1,0,0,1
966269,10/23 12:15 PM,F3XN,2,4,0,0,6
966268,10/23 12:14 PM,F3XN,119,1,0,0,120
966267,10/23 12:14 PM,F3N,3,2,0,0,5
966266,10/23 12:14 PM,F3XN,23,1,0,0,24
966265,10/23 12:14 PM,F3XN,0,5,0,0,5
966264,10/23 12:14 PM,F3XN,54,0,0,0,54
966263,10/23 12:13 PM,F3XN,4,4,0,0,8
966262,10/23 12:13 PM,F3N,0,32,0,2,34
966261,10/23 12:13 PM,F3XN,5,5,0,0,10
966260,10/23 12:13 PM,F3N,138,71,0,8,217
966259,10/23 12:13 PM,F3N,59,43,0,0,102
966258,10/23 12:12 PM,F3N,4,4,0,0,8
966257,10/23 12:12 PM,F3N,10,34,0,7,51
966256,10/23 12:12 PM,F3XN,0,13,0,0,13
966255,10/23 12:11 PM,F3XN,507,2,0,0,509
966254,10/23 12:10 PM,F3XN,68,4,0,0,72
966253,10/23 12:10 PM,F3XN,0,5,0,0,5
966252,10/23 12:10 PM,F3XN,4,5,2,3,14
966251,10/23 12:09 PM,F3XN,2,6,0,0,8
966250,10/23 12:08 PM,F3N,6,12,0,4,22
966249,10/23 12:08 PM,F3XN,4,18,0,0,22
966248,10/23 12:07 PM,F3N,104,47,0,0,151
966247,10/23 12:07 PM,F3XN,3,4,0,34,41
966246,10/23 12:07 PM,F3N,7,28,0,2,37
966245,10/23 12:06 PM,F3XN,33,2,0,0,35
966244,10/23 12:05 PM,F3XN,0,1,0,0,1
966243,10/23 12:05 PM,F3XN,0,1,0,0,1
966242,10/23 12:04 PM,F3N,20,9,0,0,29
966241,10/23 12:02 PM,F3XN,8,18,0,0,26
966240,10/23 12:02 PM,F3N,106,39,0,1,146
966239,10/23 12:02 PM,F3XN,71,1,0,0,72
966238,10/23 12:02 PM,F3XN,1,1,0,0,2
966237,10/23 12:02 PM,F3XN,2,3,0,0,5
966236,10/23 12:01 PM,F3XN,42,5,0,0,47
966235,10/23 12:00 PM,F3XN,0,0,0,0,0
966234,10/23 12:00 PM,F3XN,9,8,0,52,69
966233,10/23 12:00 PM,F3XN,2,3,0,0,5
966232,10/23 12:00 PM,F3XN,2,212,0,1,215
966231,10/23 11:57 AM,F3XN,10,11,0,0,21
966230,10/23 11:57 AM,F3XN,0,0,0,0,0
966229,10/23 11:57 AM,F3A,33,11,0,3,47
966228,10/23 11:57 AM,F3A,9,16,0,0,25
966227,10/23 11:55 AM,F3XN,17,27,1,0,45
966226,10/23 11:55 AM,F3XN,0,1,0,0,1
966225,10/23 11:55 AM,F24N,0,0,1,0,1
966224,10/23 11:55 AM,F3XN,9,0,0,0,9
966223,10/23 11:54 AM,F3XN,0,0,0,0,0
966222,10/23 11:53 AM,F3XN,8,22,0,0,30
966221,10/23 11:53 AM,F3XN,20,2,0,0,22
966220,10/23 11:52 AM,F3XN,11,0,0,0,11
966219,10/23 11:52 AM,F3XN,1,3,0,0,4
966218,10/23 11:52 AM,F3XN,62,2,0,2,66
966217,10/23 11:51 AM,F3XN,0,0,0,0,0
966216,10/23 11:48 AM,F3N,93,126,0,1,220
966215,10/23 11:47 AM,F3N,4,11,0,5,20
966214,10/23 11:45 AM,F3N,97,37,0,1,135
966213,10/23 11:45 AM,F3XN,287,0,0,0,287
966212,10/23 11:45 AM,F3XN,0,0,0,0,0
966211,10/23 11:44 AM,F3XN,0,0,0,0,0
966210,10/23 11:44 AM,F3XA,30,0,0,0,30
966209,10/23 11:43 AM,F3XN,662,8,0,0,670
966208,10/23 11:42 AM,F6N,3,0,0,0,3
966207,10/23 11:42 AM,F3XN,187,19,0,0,206
966206,10/23 11:42 AM,F3XN,11,2,0,1,14
966205,10/23 11:42 AM,F3XN,0,0,2,0,2
966204,10/23 11:41 AM,F3XN,1,1,0,0,2
966203,10/23 11:41 AM,F3XN,8,3,0,0,11
966202,10/23 11:40 AM,F3XN,0,6,0,0,6
966201,10/23 11:40 AM,F6N,8,0,0,0,8
966200,10/23 11:39 AM,F3XN,0,0,0,0,0
966199,10/23 11:39 AM,F3XN,17,1,0,0,18
966198,10/23 11:39 AM,F3N,14,44,0,4,62
966197,10/23 11:39 AM,F3XN,0,0,0,0,0
966196,10/23 11:38 AM,F3XN,1,5,0,0,6
966195,10/23 11:37 AM,F3XN,0,2,0,0,2
966194,10/23 11:37 AM,F3N,3,3,0,0,6
966193,10/23 11:37 AM,F6N,1,0,0,0,1
966192,10/23 11:36 AM,F3XN,0,0,0,0,0
966191,10/23 11:36 AM,F3XN,0,2,0,0,2
966190,10/23 11:36 AM,F6N,4,0,0,0,4
966189,10/23 11:35 AM,F3XN,2,16,4,1,23
966188,10/23 11:35 AM,F6N,2,0,0,0,2
966187,10/23 11:35 AM,F3XN,16,81,0,42,139
966186,10/23 11:34 AM,F3XN,0,4,0,0,4
966185,10/23 11:34 AM,F3XN,194,11,0,1,206
966184,10/23 11:34 AM,F3N,2,2,0,0,4
966183,10/23 11:34 AM,F1N,0,0,0,0,0
966182,10/23 11:33 AM,F3XN,2,2,0,0,4
966181,10/23 11:33 AM,F3XN,0,0,0,0,0
966180,10/23 11:33 AM,F3XN,125,6,0,0,131
966179,10/23 11:33 AM,F3XN,178,15,16,0,209
966178,10/23 11:32 AM,F3XN,0,1,0,0,1
966177,10/23 11:32 AM,F3XN,120,3,0,0,123
966176,10/23 11:32 AM,F3XN,4,3,0,0,7
966175,10/23 11:32 AM,F3N,5,4,0,4,13
966174,10/23 11:32 AM,F3XN,1,6,0,0,7
966173,10/23 11:32 AM,F3XN,0,6,0,0,6
966172,10/23 11:31 AM,F3XN,0,10,0,1,11
966171,10/23 11:30 AM,F3XN,0,0,0,0,0
966170,10/23 11:30 AM,F3XN,14,2,0,1,17
966169,10/23 11:30 AM,F3XN,1,11,0,0,12
966168,10/23 11:29 AM,F3XN,2,1,0,0,3
966167,10/23 11:29 AM,F3XN,31,0,0,0,31
966166,10/23 11:28 AM,F6N,2,0,0,0,2
966165,10/23 11:28 AM,F3XN,0,2,0,0,2
966164,10/23 11:28 AM,F3XN,10,11,0,0,21
966163,10/23 11:28 AM,F3XN,592,3,0,0,595
966162,10/23 11:28 AM,F24N,0,0,2,0,2
966161,10/23 11:27 AM,F3XN,5,0,0,0,5
966160,10/23 11:25 AM,F3XN,9,8,0,0,17
966159,10/23 11:25 AM,F3XN,91,212,1,3,307
966158,10/23 11:24 AM,F3N,0,0,0,0,0
966157,10/23 11:24 AM,F3N,3,5,0,0,8
966156,10/23 11:23 AM,F3XN,0,0,0,0,0
966155,10/23 11:22 AM,F6N,5,0,0,0,5
966154,10/23 11:22 AM,F6N,1,0,0,0,1
966153,10/23 11:22 AM,F3N,0,0,0,0,0
966152,10/23 11:22 AM,F3XN,0,1,0,0,1
966151,10/23 11:21 AM,F3N,42,15,0,1,58
966150,10/23 11:21 AM,F6N,5,0,0,0,5
966149,10/23 11:20 AM,F3XN,0,0,0,0,0
966148,10/23 11:20 AM,F3XN,89,2,0,0,91
966147,10/23 11:19 AM,F3XN,1,0,0,0,1
966146,10/23 11:19 AM,F3XN,12,3,0,0,15
966145,10/23 11:18 AM,F3N,30,18,0,0,48
966144,10/23 11:18 AM,F3XN,65,2,0,0,67
966143,10/23 11:18 AM,F3XN,57,1,0,0,58
966142,10/23 11:18 AM,F3XN,4,3,0,0,7
966141,10/23 11:18 AM,F3XN,7,3,0,0,10
966140,10/23 11:17 AM,F3N,3,0,0,0,3
966139,10/23 11:17 AM,F3XN,9,25,0,0,34
966138,10/23 11:17 AM,F3XN,0,0,0,0,0
966137,10/23 11:17 AM,F3N,77,41,0,0,118
966136,10/23 11:16 AM,F6N,3,0,0,0,3
966135,10/23 11:16 AM,F3XN,1,0,0,0,1
966134,10/23 11:16 AM,F3XN,8,9,0,0,17
966133,10/23 11:15 AM,F3XN,388,66,0,0,454
966132,10/23 11:15 AM,F3XN,27,1,0,0,28
966131,10/23 11:15 AM,F3XN,0,0,0,0,0
966130,10/23 11:14 AM,F3XN,0,0,0,0,0
966129,10/23 11:13 AM,F3XN,89,7,0,0,96
966128,10/23 11:12 AM,F6N,11,0,0,0,11
966127,10/23 11:12 AM,F3XN,312,7,0,0,319
966126,10/23 11:12 AM,F3XN,716,69,8,0,793
966125,10/23 11:11 AM,F3XN,16,0,0,0,16
966124,10/23 11:11 AM,F3XN,0,1,0,0,1
966123,10/23 11:11 AM,F3XN,0,0,0,0,0
966122,10/23 11:11 AM,F3N,4,4,0,1,9
966121,10/23 11:10 AM,F3XN,4,0,0,0,4
966120,10/23 11:10 AM,F3N,93,49,0,0,142
966119,10/23 11:09 AM,F3XN,184,2,0,0,186
966118,10/23 11:09 AM,F3XN,234,118,0,0,352
966117,10/23 11:09 AM,F3XN,399,11,0,0,410
966116,10/23 11:08 AM,F3XN,5,5,0,0,10
966115,10/23 11:08 AM,F3N,47,146,0,1,194
966114,10/23 11:07 AM,F3XN,1,0,0,0,1
966113,10/23 11:07 AM,F3XN,7,0,0,0,7
966112,10/23 11:07 AM,F3N,119,127,0,0,246
966111,10/23 11:06 AM,F3XN,605,32,0,0,637
966110,10/23 11:05 AM,F3XN,2,3,6,6,17
966109,10/23 11:05 AM,F3XN,10,4,0,0,14
966108,10/23 11:04 AM,F3XN,0,9,0,0,9
966107,10/23 11:04 AM,F3XN,9,2,0,0,11
966106,10/23 11:04 AM,F6N,1,0,0,0,1
966105,10/23 11:04 AM,F3XN,11,20,0,0,31
966104,10/23 11:03 AM,F3XN,33,15,0,0,48
966103,10/23 11:03 AM,F3XN,0,1,0,0,1
966102,10/23 11:02 AM,F3XN,1,0,0,1,2
966101,10/23 11:02 AM,F3XN,0,0,0,0,0
966100,10/23 11:02 AM,F3XN,0,9,0,0,9
966099,10/23 11:01 AM,F3N,88,24,0,0,112
966098,10/23 11:01 AM,F99,0,0,0,0,0
966097,10/23 11:01 AM,F3XN,0,0,0,0,0
966096,10/23 11:00 AM,F3PN,1,7,0,1,9
966095,10/23 11:00 AM,F3N,283,33,0,27,343
966094,10/23 11:00 AM,F3XN,1,3,0,0,4
966093,10/23 11:00 AM,F3XN,0,0,0,0,0
966092,10/23 10:59 AM,F3XN,10,8,0,0,18
966091,10/23 10:59 AM,F3XN,1159,23,0,0,1182
966090,10/23 10:59 AM,F3XN,0,0,0,0,0
966089,10/23 10:59 AM,F3XN,5,1,0,0,6
966088,10/23 10:59 AM,F3XN,3,1,3,1,8
966087,10/23 10:59 AM,F3XN,0,4,0,0,4
966086,10/23 10:59 AM,F3XN,4,4,0,0,8
966085,10/23 10:58 AM,F3XN,0,2,0,0,2
966084,10/23 10:58 AM,F3XN,0,1,0,0,1
966083,10/23 10:58 AM,F3XA,0,6,0,0,6
966082,10/23 10:57 AM,F3XN,0,3,0,0,3
966081,10/23 10:55 AM,F3XN,8,2,0,0,10
966080,10/23 10:55 AM,F3XN,0,3,0,12,15
966079,10/23 10:55 AM,F3N,64,24,0,0,88
966078,10/23 10:55 AM,F6N,2,0,0,0,2
966077,10/23 10:55 AM,F3XN,19,10,0,0,29
966076,10/23 10:55 AM,F3XN,0,0,0,0,0
966075,10/23 10:55 AM,F3A,14,17,0,8,39
966074,10/23 10:54 AM,F3N,146,9,0,0,155
966073,10/23 10:54 AM,F3N,0,2,0,15,17
966072,10/23 10:53 AM,F3XN,759,15,0,0,774
966071,10/23 10:53 AM,F3XN,32,23,0,37,92
966070,10/23 10:52 AM,F3XN,9,20,0,0,29
966069,10/23 10:52 AM,F3XN,62,1,0,0,63
966068,10/23 10:51 AM,F3XN,1,0,0,1,2
966067,10/23 10:51 AM,F3XN,259,2,0,0,261
966066,10/23 10:51 AM,F3N,4,7,0,0,11
966065,10/23 10:51 AM,F3XN,0,0,0,0,0
966064,10/23 10:51 AM,F3XN,0,0,0,0,0
966063,10/23 10:51 AM,F3XN,0,0,0,0,0
966062,10/23 10:50 AM,F3XN,30,6,0,0,36
966061,10/23 10:50 AM,F3XN,0,0,1,0,1
966060,10/23 10:50 AM,F3XN,0,0,0,0,0
966059,10/23 10:49 AM,F3N,98,22,0,0,120
966058,10/23 10:49 AM,F3XN,0,0,0,0,0
966057,10/23 10:49 AM,F3XN,14,11,0,0,25
966056,10/23 10:49 AM,F3XN,0,0,8,2,10
966055,10/23 10:48 AM,F3XN,0,2,0,0,2
966054,10/23 10:48 AM,F3XN,0,0,0,0,0
966053,10/23 10:48 AM,F3N,0,0,0,0,0
966052,10/23 10:48 AM,F3XN,28,0,0,0,28
966051,10/23 10:47 AM,F3N,65,37,0,0,102
966050,10/23 10:47 AM,F3XN,2,1,0,0,3
966049,10/23 10:47 AM,F3XN,2,5,0,0,7
966048,10/23 10:46 AM,F3XN,0,0,0,0,0
966047,10/23 10:46 AM,F3XN,0,27,0,0,27
966046,10/23 10:46 AM,F3XN,60,7,0,0,67
966045,10/23 10:45 AM,F3XN,44,0,0,0,44
966044,10/23 10:45 AM,F3N,5,6,0,1,12
966043,10/23 10:45 AM,F24N,0,0,6,0,6
966042,10/23 10:44 AM,F3XA,0,0,0,0,0
966041,10/23 10:44 AM,F3XN,0,6,0,0,6
966040,10/23 10:44 AM,F3XN,152,77,0,0,229
966039,10/23 10:44 AM,F3XN,1,21,0,0,22
966038,10/23 10:43 AM,F3XN,0,2,0,0,2
966037,10/23 10:42 AM,F5N,0,0,524,0,524
966036,10/23 10:42 AM,F3XN,23,5,0,0,28
966035,10/23 10:42 AM,F3N,10,27,0,0,37
966034,10/23 10:41 AM,F3XN,0,0,0,13,13
966033,10/23 10:40 AM,F3XN,0,4,0,0,4
966032,10/23 10:39 AM,F3XN,122,3,0,0,125
966031,10/23 10:39 AM,F3XN,0,0,0,0,0
966030,10/23 10:39 AM,F3XN,1,4,0,0,5
966029,10/23 10:39 AM,F3XN,0,2,0,0,2
966028,10/23 10:39 AM,F3XN,0,1,0,0,1
966027,10/23 10:39 AM,F3XN,0,3,0,0,3
966026,10/23 10:39 AM,F3XN,0,2,0,0,2
966025,10/23 10:39 AM,F3XN,404,10,0,0,414
966024,10/23 10:39 AM,F6N,6,0,0,0,6
966023,10/23 10:38 AM,F3XN,205,3,0,0,208
966022,10/23 10:38 AM,F3XN,70,104,0,0,174
966021,10/23 10:38 AM,F3T,0,0,0,0,0
966020,10/23 10:38 AM,F3XA,17,6,0,0,23
966019,10/23 10:37 AM,F3N,60,45,0,0,105
966018,10/23 10:37 AM,F3XN,0,1,0,0,1
966017,10/23 10:36 AM,F6N,11,0,0,0,11
966016,10/23 10:36 AM,F3XN,0,1,0,0,1
966015,10/23 10:35 AM,F3XN,0,1,0,0,1
966014,10/23 10:35 AM,F6N,3,0,0,0,3
966013,10/23 10:35 AM,F3XN,91,1,0,0,92
966012,10/23 10:34 AM,F3XA,0,0,0,22,22
966011,10/23 10:34 AM,F3N,11,22,0,7,40
966010,10/23 10:34 AM,F3XN,15,10,0,0,25
966009,10/23 10:32 AM,F3N,1,6,0,0,7
966008,10/23 10:32 AM,F3N,81,93,0,0,174
966007,10/23 10:32 AM,F3N,1,1,0,4,6
966006,10/23 10:30 AM,F3XN,51,0,0,0,51
966005,10/23 10:30 AM,F3XN,16,0,0,0,16
966004,10/23 10:30 AM,F6N,15,0,0,0,15
966003,10/23 10:29 AM,F6N,3,0,0,0,3
966002,10/23 10:29 AM,F3XN,1,96,0,6,103
966001,10/23 10:28 AM,F6N,5,0,0,0,5
966000,10/23 10:28 AM,F3N,20,18,0,0,38
965999,10/23 10:27 AM,F3XN,69,1,0,0,70
965998,10/23 10:27 AM,F3XN,97,10,0,0,107
965997,10/23 10:27 AM,F24N,0,0,2,0,2
965996,10/23 10:27 AM,F3XN,0,2,0,0,2
965995,10/23 10:26 AM,F3N,3,7,0,0,10
965994,10/23 10:26 AM,F6N,3,0,0,0,3
965993,10/23 10:25 AM,F3XA,11,13,0,0,24
965992,10/23 10:25 AM,F5N,0,0,2,0,2
965991,10/23 10:24 AM,F3XN,28,10,0,0,38
965990,10/23 10:24 AM,F3XN,1184,12,0,1,1197
965989,10/23 10:24 AM,F3XN,2,19,0,0,21
965988,10/23 10:23 AM,F3XN,200,0,0,0,200
965987,10/23 10:23 AM,F3XN,4,0,0,0,4
965986,10/23 10:22 AM,F3XN,0,0,0,1,1
965985,10/23 10:22 AM,F3XN,544,31,0,0,575
965984,10/23 10:22 AM,F6N,10,0,0,0,10
965983,10/23 10:22 AM,F3XN,0,6,0,0,6
965982,10/23 10:22 AM,F3XN,0,1,0,0,1
965981,10/23 10:22 AM,F3XN,50,4,0,0,54
965980,10/23 10:22 AM,F3N,0,0,0,0,0
965979,10/23 10:21 AM,F24N,0,0,1,0,1
965978,10/23 10:21 AM,F3XN,0,0,0,0,0
965977,10/23 10:21 AM,F3XN,219,0,0,0,219
965976,10/23 10:21 AM,F3N,0,4,0,0,4
965975,10/23 10:20 AM,F3XN,83,1,0,0,84
965974,10/23 10:20 AM,F3XA,4,0,0,1,5
965973,10/23 10:20 AM,F3XN,179,6,0,0,185
965972,10/23 10:20 AM,F3XN,0,0,0,0,0
965971,10/23 10:19 AM,F3N,39,29,0,4,72
965970,10/23 10:19 AM,F3XN,8,0,0,0,8
965969,10/23 10:19 AM,F3XN,1,0,34,58,93
965968,10/23 10:19 AM,F3XN,1,0,0,0,1
965967,10/23 10:18 AM,F3XN,2,1,0,0,3
965966,10/23 10:18 AM,F3XN,0,1,0,1,2
965965,10/23 10:17 AM,F3XN,203,2,0,0,205
965964,10/23 10:17 AM,F3N,4,9,0,0,13
965962,10/23 10:17 AM,F3XN,108,10,0,0,118
965960,10/23 10:16 AM,F3XN,1,5,0,0,6
965959,10/23 10:16 AM,F3XN,73,12,0,0,85
965958,10/23 10:16 AM,F3N,22,14,0,0,36
965955,10/23 10:14 AM,F3N,3,1,0,0,4
965954,10/23 10:14 AM,F6N,6,0,0,0,6
965953,10/23 10:13 AM,F3XN,4,0,0,1,5
965952,10/23 10:13 AM,F3XN,3,2,0,0,5
965951,10/23 10:13 AM,F3XN,1,3,0,0,4
965950,10/23 10:12 AM,F3XN,7,16,0,0,23
965949,10/23 10:12 AM,F3XN,10,3,0,0,13
965948,10/23 10:12 AM,F3XN,0,1,0,0,1
965947,10/23 10:12 AM,F3XT,0,1,0,0,1
965946,10/23 10:11 AM,F3XN,18,0,0,0,18
965945,10/23 10:11 AM,F3N,7,12,0,6,25
965944,10/23 10:11 AM,F3XN,2,0,0,26,28
965943,10/23 10:11 AM,F3XN,0,0,0,0,0
965942,10/23 10:10 AM,F3XN,0,4,0,0,4
965941,10/23 10:10 AM,F3N,59,65,0,4,128
965940,10/23 10:10 AM,F3XN,0,1,0,0,1
965939,10/23 10:10 AM,F3XN,0,0,0,0,0
965938,10/23 10:10 AM,F3XN,0,1,0,0,1
965937,10/23 10:10 AM,F3XN,59,0,0,0,59
965936,10/23 10:09 AM,F3XN,2,0,0,1,3
965935,10/23 10:09 AM,F3XN,29,0,0,0,29
965934,10/23 10:09 AM,F3XN,0,0,0,0,0
965933,10/23 10:08 AM,F24N,0,0,1,0,1
965932,10/23 10:07 AM,F3XN,0,8,0,0,8
965931,10/23 10:08 AM,F3N,25,26,0,0,51
965930,10/23 10:07 AM,F3XN,0,3,0,0,3
965929,10/23 10:06 AM,F3XN,3,3,0,0,6
965928,10/23 10:06 AM,F3XN,60,2,0,0,62
965927,10/23 10:05 AM,F3XN,0,0,0,0,0
965926,10/23 10:05 AM,F3XN,6,12,0,0,18
965925,10/23 10:04 AM,F3XN,0,0,0,0,0
965924,10/23 10:04 AM,F3XN,1,3,0,0,4
965923,10/23 10:04 AM,F6N,3,0,0,0,3
965922,10/23 10:04 AM,F3XN,0,3,0,0,3
965921,10/23 10:03 AM,F3XN,4,11,0,16,31
965920,10/23 10:03 AM,F3XN,16,1,0,0,17
965919,10/23 10:02 AM,F6N,1,0,0,0,1
965918,10/23 10:02 AM,F3XN,137,0,0,0,137
965917,10/23 10:01 AM,F3XN,0,0,0,12,12
965916,10/23 10:01 AM,F3XN,246,43,0,0,289
965915,10/23 10:01 AM,F3N,23,26,0,0,49
965914,10/23 10:00 AM,F3XN,0,8,0,0,8
965913,10/23 10:00 AM,F3XN,4,0,0,0,4
965912,10/23 10:00 AM,F3XN,5,7,0,0,12
965911,10/23 09:59 AM,F3XN,801,26,0,2,829
965910,10/23 09:59 AM,F3N,25,29,0,0,54
965909,10/23 09:58 AM,F3XN,5,14,0,0,19
965908,10/23 09:57 AM,F3XN,0,0,0,0,0
965907,10/23 09:57 AM,F3N,115,33,0,2,150
965906,10/23 09:54 AM,F3XN,8,1,0,0,9
965905,10/23 09:53 AM,F3XN,28,10,0,0,38
965904,10/23 09:53 AM,F3N,31,28,0,1,60
965903,10/23 09:52 AM,F3XN,20,7,0,0,27
965902,10/23 09:52 AM,F3XN,4,11,13,3,31
965901,10/23 09:52 AM,F3XN,0,1,0,0,1
965900,10/23 09:51 AM,F3XN,2,1,1,0,4
965899,10/23 09:51 AM,F3XN,21,5,0,0,26
965898,10/23 09:51 AM,F3XN,1,0,0,0,1
965897,10/23 09:50 AM,F3XN,32,2,0,0,34
965896,10/23 09:50 AM,F24N,0,0,1,0,1
965895,10/23 09:50 AM,F3XN,1724,63,0,0,1787
965894,10/23 09:49 AM,F6N,1,0,0,0,1
965893,10/23 09:49 AM,F3XN,2,34,0,0,36
965892,10/23 09:49 AM,F3XN,1,30,0,0,31
965891,10/23 09:48 AM,F3XN,0,0,0,0,0
965890,10/23 09:48 AM,F6N,2,0,0,0,2
965889,10/23 09:47 AM,F3XN,116,9,0,0,125
965888,10/23 09:47 AM,F3N,137,137,0,14,288
965887,10/23 09:47 AM,F3XN,37,51,0,67,155
965886,10/23 09:45 AM,F3XN,5,0,0,0,5
965885,10/23 09:45 AM,F3XN,0,3,0,0,3
965884,10/23 09:45 AM,F3XN,0,6,0,0,6
965883,10/23 09:44 AM,F3XN,100,3,0,0,103
965882,10/23 09:44 AM,F3XN,12,0,0,0,12
965881,10/23 09:43 AM,F24N,0,0,1,0,1
965880,10/23 09:42 AM,F6N,1,0,0,0,1
965879,10/23 09:42 AM,F6N,1,0,0,0,1
965878,10/23 09:41 AM,F24N,0,0,1,0,1
965877,10/23 09:40 AM,F24N,0,0,1,0,1
965876,10/23 09:39 AM,F3XN,224,11,0,0,235
965875,10/23 09:39 AM,F3XN,64,9,0,0,73
965874,10/23 09:38 AM,F3XN,4,2,22,1,29
965873,10/23 09:38 AM,F3N,34,36,0,0,70
965872,10/23 09:38 AM,F3XN,225,0,0,0,225
965871,10/23 09:37 AM,F24N,0,0,1,0,1
965870,10/23 09:37 AM,F3N,21,3,0,2,26
965869,10/23 09:35 AM,F3XN,6,1,0,0,7
965868,10/23 09:35 AM,F3XN,12,4,0,0,16
965867,10/23 09:35 AM,F3XN,89,21,0,0,110
965866,10/23 09:35 AM,F3XN,21,0,0,0,21
965865,10/23 09:35 AM,F24N,0,0,1,0,1
965864,10/23 09:34 AM,F3N,98,34,0,0,132
965863,10/23 09:34 AM,F24N,0,0,1,0,1
965862,10/23 09:34 AM,F3XN,0,0,0,0,0
965861,10/23 09:31 AM,F3XN,0,0,0,0,0
965860,10/23 09:31 AM,F3XN,17,1,0,0,18
965859,10/23 09:31 AM,F3XN,24,7,0,0,31
965858,10/23 09:30 AM,F3XN,0,0,0,0,0
965857,10/23 09:30 AM,F3XN,0,4,0,0,4
965856,10/23 09:30 AM,F3N,0,0,0,0,0
965855,10/23 09:29 AM,F3XN,1,8,0,0,9
965854,10/23 09:28 AM,F3XN,8,5,0,0,13
965853,10/23 09:28 AM,F3XN,2,0,0,0,2
965852,10/23 09:28 AM,F3XN,0,0,0,2,2
965851,10/23 09:27 AM,F3XN,4,8,0,0,12
965850,10/23 09:27 AM,F3N,0,0,0,0,0
965849,10/23 09:26 AM,F3XN,49,1,0,0,50
965848,10/23 09:25 AM,F3XN,52,3,0,0,55
965847,10/23 09:25 AM,F3N,50,31,0,0,81
965846,10/23 09:24 AM,F3XN,4,3,0,0,7
965845,10/23 09:24 AM,F3XN,600,87,0,0,687
965844,10/23 09:23 AM,F3N,85,14,0,62,161
965843,10/23 09:22 AM,F3XN,14,9,0,28,51
965842,10/23 09:22 AM,F3N,0,0,0,0,0
965841,10/23 09:21 AM,F3XN,0,0,0,0,0
965840,10/23 09:20 AM,F3XN,0,26,0,22,48
965839,10/23 09:20 AM,F3XN,87,16,0,0,103
965838,10/23 09:19 AM,F3XN,415,28,0,0,443
965837,10/23 09:19 AM,F6N,6,0,0,0,6
965836,10/23 09:18 AM,F3N,0,0,0,0,0
965835,10/23 09:17 AM,F3XN,98,1,0,0,99
965834,10/23 09:17 AM,F3N,3,2,0,0,5
965833,10/23 09:16 AM,F3XN,0,75,0,1,76
965832,10/23 09:16 AM,F3N,320,11,0,236,567
965831,10/23 09:15 AM,F6N,3,0,0,0,3
965830,10/23 09:14 AM,F6N,2,0,0,0,2
965829,10/23 09:14 AM,F3XN,362,14,0,0,376
965828,10/23 09:14 AM,F3N,2,1,0,2,5
965827,10/23 09:12 AM,F3N,3,2,0,0,5
965826,10/23 09:11 AM,F3N,0,0,0,0,0
965825,10/23 09:10 AM,F5N,0,0,1,0,1
965824,10/23 09:09 AM,F3N,33,55,0,0,88
965823,10/23 09:09 AM,F3XN,2,2,0,0,4
965822,10/23 09:09 AM,F3XN,0,0,0,0,0
965821,10/23 09:09 AM,F3XN,122,11,0,0,133
965820,10/23 09:09 AM,F3N,4,2,0,1,7
965819,10/23 09:09 AM,F5N,0,0,1,0,1
965818,10/23 09:09 AM,F3XN,0,0,0,0,0
965817,10/23 09:08 AM,F24N,0,0,2,0,2
965816,10/23 09:06 AM,F24N,0,0,1,0,1
965815,10/23 09:06 AM,F3XN,0,1,0,0,1
965814,10/23 09:06 AM,F3N,87,2,0,0,89
965813,10/23 09:06 AM,F3XN,0,0,0,0,0
965812,10/23 09:06 AM,F3XN,100,7,0,0,107
965811,10/23 09:04 AM,F3N,71,48,0,1,120
965810,10/23 09:03 AM,F3XN,46,0,0,0,46
965809,10/23 09:03 AM,F3XA,10,25,0,1,36
965808,10/23 09:03 AM,F3N,48,38,0,9,95
965807,10/23 09:02 AM,F3XN,616,166,0,0,782
965806,10/23 09:02 AM,F3XN,19,13,0,0,32
965805,10/23 09:00 AM,F3XN,0,2,0,0,2
965804,10/23 08:59 AM,F3XN,116,4,0,0,120
965803,10/23 08:59 AM,F3XN,0,1,0,0,1
965802,10/23 08:57 AM,F3XN,0,0,0,0,0
965801,10/23 08:57 AM,F3XN,38,3,0,0,41
965799,10/23 08:54 AM,F99,0,0,0,0,0
965798,10/23 08:52 AM,F3N,42,5,0,0,47
965797,10/23 08:50 AM,F3XN,326,0,0,0,326
965796,10/23 08:51 AM,F6N,2,0,0,0,2
965795,10/23 08:50 AM,F3XN,0,2,0,0,2
965794,10/23 08:48 AM,F6N,3,0,0,0,3
965793,10/23 08:41 AM,F3XN,2,1,0,1,4
965791,10/23 08:41 AM,F3XN,0,3,0,0,3
965790,10/23 08:38 AM,F3N,0,0,0,8,8
965789,10/23 08:38 AM,F3XN,14,11,0,1,26
965788,10/23 08:37 AM,F3XN,0,3,0,0,3
965787,10/23 08:34 AM,F24N,0,0,6,0,6
965786,10/23 08:31 AM,F3XN,0,3,0,0,3
965785,10/23 08:28 AM,F6N,12,0,0,0,12
965784,10/23 08:22 AM,F3XN,3,0,0,0,3
965783,10/23 08:17 AM,F6N,2,0,0,0,2
965782,10/23 08:17 AM,F3XN,9,0,0,0,9
965781,10/23 08:17 AM,F3N,0,0,0,0,0
965780,10/23 08:17 AM,F3XN,1,0,0,0,1
965779,10/23 08:14 AM,F3XN,0,0,0,0,0
965778,10/23 08:12 AM,F3XN,2,11,0,1,14
965777,10/23 08:09 AM,F3XN,0,6,0,0,6
965776,10/23 07:56 AM,F3N,9,15,0,0,24
965775,10/23 07:47 AM,F3XN,4,6,0,0,10
965774,10/23 07:47 AM,F3XN,1,4,0,3,8
965773,10/23 07:43 AM,F6N,2,0,0,0,2
965772,10/23 07:33 AM,F3XN,0,0,0,0,0
965771,10/23 07:32 AM,F3N,1,4,0,1,6
965770,10/23 07:24 AM,F3XN,0,0,0,0,0
965769,10/23 06:59 AM,F6N,25,0,0,0,25
965768,10/23 06:43 AM,F3XN,0,0,0,0,0
965767,10/23 06:43 AM,F3N,25,13,0,2,40
965766,10/23 05:33 AM,F6N,1,0,0,0,1
965765,10/23 05:24 AM,F6N,3,0,0,0,3
965764,10/23 04:31 AM,F3XN,0,1,0,0,1
965763,10/23 04:27 AM,F3XN,12,5,0,0,17
965762,10/23 04:23 AM,F3XN,3,8,0,0,11
965761,10/23 04:22 AM,F3N,42,27,0,0,69
965760,10/23 04:19 AM,F6A,3,0,0,0,3
965759,10/23 04:18 AM,F3XN,3,11,0,0,14
965758,10/23 04:15 AM,F3XN,17,8,0,0,25
965757,10/23 04:14 AM,F3XN,0,0,0,0,0
965756,10/23 04:11 AM,F3XN,0,0,0,0,0
965755,10/23 04:04 AM,F3XN,17,1,0,0,18
965754,10/23 04:03 AM,F3XN,0,2,0,2,4
965753,10/23 04:00 AM,F3XN,9,21,0,0,30
965752,10/23 03:55 AM,F3XN,4,6,0,0,10
965751,10/23 03:52 AM,F1A,0,0,0,0,0
965750,10/23 03:51 AM,F3XN,1,1,0,0,2
965749,10/23 03:50 AM,F6N,3,0,0,0,3
965748,10/23 03:48 AM,F3XN,2,1,0,0,3
965747,10/23 03:45 AM,F3XN,0,3,0,0,3
965746,10/23 03:44 AM,F3XN,0,3,0,0,3
965745,10/23 03:41 AM,F3XN,20,33,0,0,53
965744,10/23 03:36 AM,F3XN,8,6,0,0,14
965743,10/23 03:32 AM,F3XN,4,4,0,0,8
965742,10/23 03:32 AM,F3XN,100,1,0,0,101
965741,10/23 03:25 AM,F3N,9,25,0,0,34
965740,10/23 03:23 AM,F3XN,97,0,0,0,97
965739,10/23 03:20 AM,F3XN,3,3,0,0,6
965738,10/23 03:20 AM,F3XN,0,4,0,0,4
965737,10/23 03:20 AM,F3XN,19,1,0,0,20
965736,10/23 03:17 AM,F3XN,2,2,0,0,4
965735,10/23 03:16 AM,F3XN,75,8,0,0,83
965734,10/23 03:14 AM,F3XN,0,0,0,0,0
965733,10/23 03:13 AM,F3XN,2,0,0,0,2
965732,10/23 03:13 AM,F3N,1,7,0,0,8
965731,10/23 03:12 AM,F3XA,0,26,0,0,26
965730,10/23 03:11 AM,F3XN,0,0,0,0,0
965729,10/23 03:09 AM,F3A,89,53,0,14,156
965728,10/23 03:09 AM,F3N,21,13,0,0,34
965727,10/23 03:06 AM,F3XN,0,0,0,0,0
965726,10/23 03:04 AM,F3N,18,19,0,0,37
965725,10/23 03:03 AM,F3XN,0,0,0,0,0
965724,10/23 02:57 AM,F3N,3,5,0,0,8
965723,10/23 02:57 AM,F3XN,0,1,0,0,1
965722,10/23 02:57 AM,F3XN,0,0,2,2,4
965721,10/23 02:53 AM,F3N,64,30,0,3,97
965720,10/23 02:49 AM,F3XN,0,2,0,0,2
965719,10/23 02:45 AM,F3XN,47,0,0,0,47
965718,10/23 02:42 AM,F3XN,0,1,0,0,1
965717,10/23 02:40 AM,F3A,104,31,0,8,143
965716,10/23 02:39 AM,F3XN,0,1,0,0,1
965715,10/23 02:38 AM,F3XN,5,2,0,0,7
965714,10/23 02:35 AM,F3XN,185,8,0,1,194
965713,10/23 02:17 AM,F3XN,3,40,0,0,43
965712,10/23 02:16 AM,F3XN,0,10,0,1,11
965711,10/23 02:01 AM,F6N,7,0,0,0,7
965710,10/23 01:57 AM,F6N,16,0,0,0,16
965709,10/23 01:54 AM,F3XN,13,40,0,0,53
965708,10/23 01:50 AM,F3XN,0,0,0,0,0
965707,10/23 01:41 AM,F3XN,0,4,0,0,4
965706,10/23 01:36 AM,F3XN,0,3,0,0,3
965705,10/23 01:30 AM,F3XN,85,6,0,0,91
965704,10/23 01:30 AM,F3N,245,39,0,2,286
965703,10/23 01:28 AM,F3XN,0,0,0,0,0
965702,10/23 01:28 AM,F3XN,5,0,0,0,5
965701,10/23 01:28 AM,F3A,15,26,0,1,42
965700,10/23 01:26 AM,F3A,38,89,0,1,128
965699,10/23 01:25 AM,F3XN,2,0,0,0,2
965698,10/23 01:23 AM,F3XN,5,3,0,0,8
965697,10/23 01:20 AM,F3XN,12,0,0,0,12
965696,10/23 01:18 AM,F3XN,35,0,0,0,35
965695,10/23 01:17 AM,F3XN,0,2,0,0,2
965694,10/23 01:16 AM,F3XN,0,0,0,0,0
965693,10/23 01:13 AM,F3N,33,49,0,0,82
965692,10/23 01:07 AM,F3XN,61,3,0,0,64
965691,10/23 01:06 AM,F3XN,0,0,0,0,0
965690,10/23 01:05 AM,F6N,4,0,0,0,4
965689,10/23 01:05 AM,F3N,15,26,0,1,42
965688,10/23 01:02 AM,F3XN,0,0,0,0,0
965687,10/23 12:59 AM,F3XN,71,8,0,0,79
965686,10/23 12:58 AM,F6N,2,0,0,0,2
965685,10/23 12:53 AM,F3XN,3,2,0,0,5
965684,10/23 12:44 AM,F3N,6,17,0,2,25
965683,10/23 12:39 AM,F6N,1,0,0,0,1
965682,10/23 12:38 AM,F3N,2,3,0,0,5
965681,10/23 12:36 AM,F3N,10,3,0,3,16
965680,10/23 12:34 AM,F3XN,0,0,0,0,0
965679,10/23 12:32 AM,F3N,33,32,0,0,65
965678,10/23 12:31 AM,F3XN,0,6,0,0,6
965677,10/23 12:29 AM,F3XA,0,1,0,1,2
965676,10/23 12:29 AM,F3XN,4,2,0,0,6
965675,10/23 12:19 AM,F3XA,0,1,0,1,2
965674,10/23 12:13 AM,F3XN,0,8,0,0,8
965673,10/23 12:11 AM,F3XN,26,0,0,0,26
965672,10/23 12:10 AM,F3A,68,35,0,18,121
965671,10/23 12:09 AM,F3N,25,15,0,2,42
965670,10/23 12:02 AM,F6N,4,0,0,0,4
965669,10/23 12:00 AM,F6N,4,0,0,0,4
