filing_number,time_filed,form_type,skeda_lines,skedb_lines,skede_lines,other_lines,total_lines
959818,10/15 11:59 PM,F3T,0,1,0,0,1
959817,10/15 11:58 PM,F3N,4308,295,0,3,4606
959816,10/15 11:58 PM,F3XN,0,0,0,0,0
959815,10/15 11:57 PM,F3N,3,4,0,1,8
959814,10/15 11:57 PM,F3N,370,182,0,1,553
959813,10/15 11:56 PM,F3N,38,62,0,1,101
959812,10/15 11:55 PM,F3N,22,30,0,5,57
959811,10/15 11:55 PM,F3N,80,53,0,5,138
959810,10/15 11:55 PM,F3XN,1,0,2,3,6
959809,10/15 11:54 PM,F3XN,0,0,0,7,7
959808,10/15 11:54 PM,F3XN,1,0,2,3,6
959807,10/15 11:53 PM,F3N,1349,470,0,7,1826
959806,10/15 11:53 PM,F3XN,1,0,2,3,6
959805,10/15 11:52 PM,F3XN,1,0,2,3,6
959804,10/15 11:52 PM,F3XA,0,1,0,4,5
959803,10/15 11:51 PM,F3XN,11,25,0,0,36
959802,10/15 11:51 PM,F3N,161,58,0,10,229
959801,10/15 11:51 PM,F3XN,0,0,0,0,0
959800,10/15 11:50 PM,F3XN,19,0,0,0,19
959799,10/15 11:50 PM,F3N,0,1,0,0,1
959798,10/15 11:49 PM,F3XN,19,100,142,6,267
959797,10/15 11:48 PM,F3XN,0,0,0,6,6
959796,10/15 11:47 PM,F3A,66,70,0,0,136
959795,10/15 11:47 PM,F3N,329,197,0,0,526
959794,10/15 11:45 PM,F3XN,71,45,0,0,116
959793,10/15 11:44 PM,F3XN,9,52,35,0,96
959792,10/15 11:43 PM,F1A,0,0,0,0,0
959791,10/15 11:43 PM,F3XN,0,0,0,3,3
959790,10/15 11:41 PM,F3N,152,87,0,3,242
959789,10/15 11:41 PM,F3XN,4,23,0,1,28
959788,10/15 11:40 PM,F3XN,0,0,0,0,0
959787,10/15 11:39 PM,F3N,2760,471,0,7,3238
959786,10/15 11:39 PM,F3XN,2,3,5,0,10
959785,10/15 11:38 PM,F3N,27,18,0,2,47
959784,10/15 11:38 PM,F3N,21,3,0,0,24
959783,10/15 11:36 PM,F3N,193,240,0,3,436
959782,10/15 11:36 PM,F3XN,24,9,0,8,41
959781,10/15 11:35 PM,F3N,290,210,0,0,500
959780,10/15 11:32 PM,F3N,98,75,0,0,173
959779,10/15 11:31 PM,F3N,1309,276,0,1,1586
959778,10/15 11:30 PM,F3XN,7,118,116,0,241
959777,10/15 11:30 PM,F3XN,30,1227,0,8,1265
959776,10/15 11:30 PM,F3N,337,164,0,7,508
959775,10/15 11:28 PM,F3N,43,75,0,0,118
959774,10/15 11:28 PM,F3XN,3,2,0,0,5
959773,10/15 11:27 PM,F3XN,16,0,0,0,16
959772,10/15 11:27 PM,F3N,764,177,0,6,947
959771,10/15 11:27 PM,F3XN,0,0,0,0,0
959770,10/15 11:27 PM,F3N,252,133,0,0,385
959769,10/15 11:25 PM,F3N,6,16,0,0,22
959768,10/15 11:24 PM,F3N,177,276,0,2,455
959767,10/15 11:22 PM,F3A,64,29,0,3,96
959766,10/15 11:21 PM,F24N,0,0,2,0,2
959765,10/15 11:21 PM,F3XN,0,0,0,0,0
959764,10/15 11:21 PM,F3N,0,12,0,0,12
959763,10/15 11:21 PM,F3PN,29,282,0,15,326
959762,10/15 11:20 PM,F3N,338,159,0,5,502
959761,10/15 11:18 PM,F3N,683,127,0,15,825
959760,10/15 11:16 PM,F3XN,2402,1361,0,4,3767
959759,10/15 11:16 PM,F3N,1,2,0,3,6
959758,10/15 11:15 PM,F99,0,0,0,0,0
959757,10/15 11:14 PM,F3N,0,1,0,4,5
959756,10/15 11:14 PM,F3XN,60,13,0,1,74
959755,10/15 11:14 PM,F3N,26,27,0,14,67
959754,10/15 11:14 PM,F3N,87,123,0,0,210
959753,10/15 11:14 PM,F3N,0,0,0,15,15
959752,10/15 11:12 PM,F3XN,34,79,3,0,116
959751,10/15 11:10 PM,F3XA,16,17,0,12,45
959750,10/15 11:10 PM,F3XN,1354,154,14,0,1522
959749,10/15 11:09 PM,F3N,137,133,0,1,271
959748,10/15 11:08 PM,F3XN,0,0,0,0,0
959747,10/15 11:08 PM,F3N,148,79,0,0,227
959746,10/15 11:08 PM,F3XA,3,13,0,0,16
959745,10/15 11:06 PM,F3N,350,400,0,57,807
959744,10/15 11:05 PM,F3XA,8,5,0,6,19
959743,10/15 11:04 PM,F3N,985,137,0,0,1122
959742,10/15 11:03 PM,F3N,71,70,0,1,142
959741,10/15 11:03 PM,F3XN,6,27,0,0,33
959740,10/15 11:03 PM,F3N,448,163,0,1,612
959739,10/15 11:02 PM,F24N,0,0,5,0,5
959738,10/15 11:02 PM,F3XN,0,0,0,0,0
959737,10/15 11:02 PM,F3N,509,195,0,0,704
959736,10/15 11:02 PM,F99,0,0,0,0,0
959735,10/15 11:01 PM,F3XN,0,1,0,0,1
959734,10/15 11:01 PM,F3N,358,173,0,2,533
959733,10/15 11:00 PM,F3XN,8,53,0,0,61
959732,10/15 11:00 PM,F3N,68,36,0,3,107
959731,10/15 11:00 PM,F3N,327,157,0,0,484
959730,10/15 10:59 PM,F24N,0,0,1,0,1
959729,10/15 10:59 PM,F3XN,0,0,0,0,0
959728,10/15 10:59 PM,F99,0,0,0,0,0
959727,10/15 10:58 PM,F3N,69,95,0,11,175
959726,10/15 10:58 PM,F3N,2,12,0,5,19
959725,10/15 10:57 PM,F3N,109,72,0,2,183
959724,10/15 10:57 PM,F3XN,1,8,0,13,22
959723,10/15 10:56 PM,F3N,42,79,0,29,150
959722,10/15 10:56 PM,F3N,0,5,0,15,20
959721,10/15 10:55 PM,F3XN,492,50,4,1,547
959720,10/15 10:55 PM,F3N,502,222,0,12,736
959719,10/15 10:55 PM,F3N,11,15,0,11,37
959718,10/15 10:55 PM,F3N,1,16,0,0,17
959717,10/15 10:54 PM,F3N,1,0,0,0,1
959716,10/15 10:52 PM,F3N,55,111,0,12,178
959715,10/15 10:51 PM,F3XN,0,0,0,0,0
959714,10/15 10:50 PM,F3XN,0,4,0,0,4
959713,10/15 10:50 PM,F3N,107,97,0,4,208
959712,10/15 10:49 PM,F3N,1352,200,0,15,1567
959711,10/15 10:48 PM,F3N,472,371,0,5,848
959710,10/15 10:48 PM,F3XN,106,75,0,14,195
959709,10/15 10:47 PM,F3N,662,183,0,3,848
959708,10/15 10:45 PM,F3N,253,117,0,17,387
959707,10/15 10:44 PM,F3N,267,223,0,12,502
959706,10/15 10:43 PM,F3N,621,215,0,0,836
959705,10/15 10:43 PM,F3N,7,5,0,1,13
959704,10/15 10:42 PM,F3XN,20,6,7,7,40
959703,10/15 10:42 PM,F3N,3,17,0,0,20
959702,10/15 10:42 PM,F3XN,80,2,0,2,84
959701,10/15 10:41 PM,F3N,65,34,0,5,104
959700,10/15 10:40 PM,F3N,1,2,0,0,3
959699,10/15 10:40 PM,F3XN,8,9,0,0,17
959698,10/15 10:36 PM,F3XN,1,0,0,0,1
959697,10/15 10:35 PM,F5N,0,0,1,0,1
959696,10/15 10:35 PM,F3N,400,174,0,0,574
959695,10/15 10:34 PM,F3N,151,70,0,0,221
959694,10/15 10:33 PM,F3XN,0,0,0,0,0
959693,10/15 10:33 PM,F3N,0,0,0,11,11
959692,10/15 10:33 PM,F3XN,351,23,0,0,374
959691,10/15 10:32 PM,F3XN,0,1,0,0,1
959690,10/15 10:32 PM,F3XN,26,32,0,0,58
959689,10/15 10:32 PM,F99,0,0,0,0,0
959688,10/15 10:32 PM,F3XN,6,1,0,10,17
959687,10/15 10:31 PM,F3N,0,0,0,1,1
959686,10/15 10:31 PM,F3N,1916,382,0,0,2298
959685,10/15 10:31 PM,F3A,44,48,0,2,94
959684,10/15 10:30 PM,F3N,47,56,0,12,115
959683,10/15 10:30 PM,F3N,135,78,0,13,226
959682,10/15 10:29 PM,F3N,0,0,0,5,5
959681,10/15 10:28 PM,F3N,45,163,0,6,214
959680,10/15 10:27 PM,F3XN,119,0,0,113,232
959679,10/15 10:27 PM,F3N,10,12,0,12,34
959678,10/15 10:26 PM,F3N,690,172,0,11,873
959677,10/15 10:25 PM,F3N,0,0,0,0,0
959676,10/15 10:25 PM,F3N,0,4,0,1,5
959675,10/15 10:25 PM,F3XN,0,1,0,0,1
959674,10/15 10:24 PM,F3XN,57,10,0,3,70
959673,10/15 10:24 PM,F3XN,0,0,0,0,0
959672,10/15 10:24 PM,F3XA,264,3,0,1,268
959671,10/15 10:24 PM,F3N,124,48,0,12,184
959670,10/15 10:23 PM,F3XN,5,0,0,0,5
959669,10/15 10:23 PM,F3XN,8,51,0,16,75
959668,10/15 10:23 PM,F3N,0,0,0,0,0
959667,10/15 10:22 PM,F3XN,0,4,0,6,10
959666,10/15 10:22 PM,F3N,116,92,0,0,208
959665,10/15 10:22 PM,F3N,4173,290,0,2,4465
959664,10/15 10:21 PM,F3N,0,0,0,0,0
959663,10/15 10:21 PM,F3N,318,140,0,2,460
959662,10/15 10:21 PM,F3XN,36,7,0,3,46
959661,10/15 10:21 PM,F3N,17,65,0,3,85
959660,10/15 10:21 PM,F3XN,1,0,0,0,1
959659,10/15 10:20 PM,F3XN,1,0,0,5,6
959658,10/15 10:20 PM,F3N,38,94,0,0,132
959657,10/15 10:19 PM,F3N,1,2,0,18,21
959656,10/15 10:19 PM,F3N,120,17,0,0,137
959655,10/15 10:19 PM,F3XN,22,1,0,0,23
959654,10/15 10:18 PM,F3XN,0,0,0,0,0
959653,10/15 10:18 PM,F3N,72,54,0,3,129
959652,10/15 10:18 PM,F3N,1,0,0,1,2
959651,10/15 10:17 PM,F3XN,0,0,0,0,0
959650,10/15 10:17 PM,F3N,23,46,0,1,70
959649,10/15 10:16 PM,F3N,0,0,0,6,6
959648,10/15 10:16 PM,F3N,108,109,0,96,313
959647,10/15 10:16 PM,F3N,98,63,0,5,166
959646,10/15 10:15 PM,F3XN,0,0,0,0,0
959645,10/15 10:15 PM,F3N,2813,266,0,4,3083
959644,10/15 10:15 PM,F3XN,57,11,0,3,71
959643,10/15 10:14 PM,F3XN,1,4,0,0,5
959642,10/15 10:13 PM,F3N,6,31,0,18,55
959641,10/15 10:13 PM,F1N,0,0,0,0,0
959640,10/15 10:12 PM,F3N,0,1,0,6,7
959639,10/15 10:11 PM,F3N,18,18,0,0,36
959638,10/15 10:11 PM,F3XN,0,0,0,4,4
959637,10/15 10:10 PM,F3N,4,0,0,0,4
959636,10/15 10:09 PM,F3N,127,149,0,4,280
959635,10/15 10:09 PM,F3N,0,0,0,8,8
959634,10/15 10:08 PM,F3XN,0,0,0,0,0
959633,10/15 10:05 PM,F3N,74,254,0,0,328
959632,10/15 10:03 PM,F3XN,140,77,0,0,217
959631,10/15 10:03 PM,F3N,341,128,0,8,477
959630,10/15 10:03 PM,F3XN,26,0,0,0,26
959629,10/15 10:01 PM,F3N,141,122,0,1,264
959628,10/15 10:00 PM,F3N,44,31,0,0,75
959627,10/15 10:00 PM,F3N,0,1,0,1,2
959626,10/15 10:00 PM,F3N,126,83,0,4,213
959625,10/15 09:59 PM,F3N,621,208,0,0,829
959624,10/15 09:58 PM,F3N,0,0,0,0,0
959623,10/15 09:57 PM,F3N,624,106,0,7,737
959622,10/15 09:57 PM,F3XN,60,21,0,0,81
959621,10/15 09:57 PM,F3N,140,114,0,0,254
959620,10/15 09:56 PM,F3N,0,0,0,0,0
959619,10/15 09:56 PM,F3N,352,177,0,10,539
959618,10/15 09:56 PM,F3N,5,96,0,8,109
959617,10/15 09:55 PM,F3N,158,118,0,3,279
959616,10/15 09:53 PM,F3N,178,113,0,2,293
959615,10/15 09:53 PM,F3N,134,110,0,0,244
959614,10/15 09:53 PM,F3N,78,50,0,5,133
959613,10/15 09:52 PM,F3XN,5,4,0,5,14
959612,10/15 09:52 PM,F3XN,14,17,0,0,31
959611,10/15 09:51 PM,F3N,160,137,0,1,298
959610,10/15 09:50 PM,F3N,1,8,0,1,10
959609,10/15 09:50 PM,F3N,0,0,0,12,12
959608,10/15 09:49 PM,F3XN,18,10,0,0,28
959607,10/15 09:49 PM,F3N,41,31,0,8,80
959606,10/15 09:49 PM,F3XN,0,0,0,0,0
959605,10/15 09:48 PM,F3XN,386,118,0,24,528
959604,10/15 09:47 PM,F3N,375,67,0,0,442
959603,10/15 09:46 PM,F3XN,3,22,0,0,25
959602,10/15 09:46 PM,F3XN,0,0,0,0,0
959601,10/15 09:46 PM,F3XN,0,0,0,0,0
959600,10/15 09:46 PM,F3N,169,66,0,2,237
959599,10/15 09:45 PM,F3N,4652,410,0,40,5102
959598,10/15 09:45 PM,F3N,1,8,0,12,21
959597,10/15 09:43 PM,F3XN,10,4,13,3,30
959596,10/15 09:43 PM,F3N,0,0,0,0,0
959595,10/15 09:42 PM,F3N,0,0,0,22,22
959594,10/15 09:41 PM,F3A,119,49,0,5,173
959593,10/15 09:40 PM,F3XN,0,0,0,0,0
959592,10/15 09:40 PM,F3N,119,122,0,9,250
959591,10/15 09:38 PM,F3XN,0,0,0,0,0
959590,10/15 09:37 PM,F3N,348,36,0,1,385
959589,10/15 09:37 PM,F3N,121,136,0,0,257
959588,10/15 09:37 PM,F3N,0,0,0,1,1
959587,10/15 09:37 PM,F3N,7,20,0,26,53
959586,10/15 09:37 PM,F3XN,1,18,0,0,19
959585,10/15 09:36 PM,F3N,1,4,0,1,6
959584,10/15 09:36 PM,F3N,10,4,0,1,15
959583,10/15 09:35 PM,F3N,0,0,0,0,0
959582,10/15 09:35 PM,F3XN,44,1,0,0,45
959581,10/15 09:34 PM,F3N,305,286,0,38,629
959580,10/15 09:34 PM,F3XN,0,103,0,1,104
959579,10/15 09:33 PM,F3XN,8,46,34,28,116
959578,10/15 09:33 PM,F3A,104,99,0,4,207
959577,10/15 09:33 PM,F3XN,26,11,0,0,37
959576,10/15 09:32 PM,F1A,0,0,0,0,0
959575,10/15 09:32 PM,F3N,13,15,0,3,31
959574,10/15 09:31 PM,F3N,42,48,0,1,91
959573,10/15 09:31 PM,F3N,0,0,0,10,10
959572,10/15 09:31 PM,F3A,239,153,0,77,469
959571,10/15 09:31 PM,F3N,240,191,0,0,431
959570,10/15 09:31 PM,F3N,0,0,0,0,0
959569,10/15 09:30 PM,F3N,179,53,0,32,264
959568,10/15 09:30 PM,F3XN,2,3,0,0,5
959567,10/15 09:30 PM,F3XA,8,24,0,40,72
959566,10/15 09:30 PM,F3A,36,31,0,28,95
959565,10/15 09:29 PM,F3XN,29,28,0,0,57
959564,10/15 09:29 PM,F3N,0,3,0,1,4
959563,10/15 09:29 PM,F3XN,90,5,0,16,111
959562,10/15 09:29 PM,F3N,913,191,0,15,1119
959561,10/15 09:29 PM,F3N,1,25,0,1,27
959560,10/15 09:28 PM,F3N,68,23,0,1,92
959559,10/15 09:28 PM,F3XN,0,6,0,7,13
959558,10/15 09:28 PM,F3XN,0,1,0,0,1
959557,10/15 09:28 PM,F3N,14,154,0,9,177
959556,10/15 09:28 PM,F3N,83,86,0,9,178
959555,10/15 09:27 PM,F3N,90,173,0,1,264
959554,10/15 09:27 PM,F3XN,0,0,0,0,0
959553,10/15 09:26 PM,F3XN,4,4,0,0,8
959552,10/15 09:25 PM,F3N,244,131,0,1,376
959551,10/15 09:25 PM,F3N,1,0,0,1,2
959550,10/15 09:24 PM,F3XN,0,0,0,0,0
959549,10/15 09:24 PM,F3N,46,128,0,7,181
959548,10/15 09:23 PM,F3N,77,108,0,3,188
959547,10/15 09:23 PM,F3N,4227,132,0,0,4359
959546,10/15 09:23 PM,F3N,84,99,0,0,183
959545,10/15 09:23 PM,F3N,0,0,0,1,1
959544,10/15 09:22 PM,F3XN,42,15,0,0,57
959543,10/15 09:22 PM,F3N,1426,251,0,0,1677
959542,10/15 09:22 PM,F3N,0,0,0,3,3
959541,10/15 09:22 PM,F3N,52,75,0,0,127
959540,10/15 09:21 PM,F3N,93,84,0,36,213
959539,10/15 09:21 PM,F3N,94,64,0,2,160
959538,10/15 09:20 PM,F24A,0,0,1,0,1
959537,10/15 09:20 PM,F3A,14,6,0,1,21
959536,10/15 09:19 PM,F3N,90,53,0,13,156
959535,10/15 09:18 PM,F3N,352,107,0,0,459
959534,10/15 09:18 PM,F3XN,23,20,9,9,61
959533,10/15 09:17 PM,F3N,1,5,0,7,13
959532,10/15 09:17 PM,F3A,9,4,0,1,14
959531,10/15 09:17 PM,F3N,915,312,0,0,1227
959530,10/15 09:16 PM,F3N,82,79,0,0,161
959529,10/15 09:16 PM,F3XN,5,2,0,20,27
959528,10/15 09:15 PM,F3N,159,64,0,5,228
959527,10/15 09:14 PM,F3XN,0,0,0,0,0
959526,10/15 09:14 PM,F5N,0,0,2,0,2
959525,10/15 09:14 PM,F24N,0,0,51,0,51
959524,10/15 09:13 PM,F3N,0,0,0,18,18
959523,10/15 09:13 PM,F3N,160,89,0,9,258
959522,10/15 09:11 PM,F3N,134,163,0,0,297
959521,10/15 09:11 PM,F3XN,3,0,0,28,31
959520,10/15 09:10 PM,F3N,160,162,0,0,322
959519,10/15 09:10 PM,F3N,237,353,0,18,608
959518,10/15 09:09 PM,F3N,102,66,0,0,168
959517,10/15 09:09 PM,F3N,245,116,0,1,362
959516,10/15 09:08 PM,F3T,4,18,0,7,29
959515,10/15 09:08 PM,F3XN,0,0,0,0,0
959514,10/15 09:07 PM,F3N,116,98,0,47,261
959513,10/15 09:07 PM,F3XN,7,28,0,0,35
959512,10/15 09:07 PM,F3N,22,26,0,4,52
959511,10/15 09:07 PM,F5N,7,0,11,0,18
959510,10/15 09:06 PM,F3A,64,70,0,0,134
959509,10/15 09:06 PM,F3A,22,33,0,2,57
959508,10/15 09:06 PM,F3N,104,31,0,7,142
959507,10/15 09:05 PM,F3XN,13,2,0,25,40
959506,10/15 09:04 PM,F3XN,0,0,0,8,8
959505,10/15 09:04 PM,F3N,446,104,0,2,552
959504,10/15 09:03 PM,F3XN,5862,720,0,9,6591
959503,10/15 09:03 PM,F3N,650,187,0,1,838
959502,10/15 09:03 PM,F3A,43,40,0,4,87
959501,10/15 09:03 PM,F5A,9,0,17,0,26
959500,10/15 09:02 PM,F3XN,305,24,0,0,329
959499,10/15 09:02 PM,F3N,4,4,0,4,12
959498,10/15 09:02 PM,F24N,0,0,195,0,195
959497,10/15 09:02 PM,F3XN,2,0,0,8,10
959496,10/15 09:02 PM,F3XN,791,358,0,0,1149
959495,10/15 09:02 PM,F3N,265,122,0,12,399
959494,10/15 09:00 PM,F3XN,492,69,0,0,561
959493,10/15 09:00 PM,F3XN,0,10,0,0,10
959492,10/15 09:00 PM,F3XN,2,9,0,0,11
959490,10/15 08:59 PM,F3N,395,185,0,0,580
959489,10/15 08:59 PM,F3N,92,50,0,9,151
959488,10/15 08:59 PM,F3N,53,104,0,1,158
959487,10/15 08:59 PM,F3N,379,178,0,0,557
959486,10/15 08:58 PM,F3N,18,19,0,0,37
959485,10/15 08:57 PM,F3A,18,17,0,4,39
959484,10/15 08:56 PM,F24A,0,0,20,0,20
959483,10/15 08:56 PM,F3XN,0,0,0,17,17
959482,10/15 08:54 PM,F24A,0,0,11,0,11
959481,10/15 08:54 PM,F3N,1,16,0,0,17
959480,10/15 08:53 PM,F3N,67,75,0,0,142
959479,10/15 08:52 PM,F3N,0,0,0,0,0
959478,10/15 08:52 PM,F3N,701,160,0,1,862
959477,10/15 08:52 PM,F3XN,0,0,0,0,0
959476,10/15 08:52 PM,F3XN,3,18,0,0,21
959475,10/15 08:51 PM,F3N,147,237,0,0,384
959474,10/15 08:50 PM,F3N,76,83,0,0,159
959473,10/15 08:50 PM,F3N,0,0,0,28,28
959472,10/15 08:50 PM,F3N,0,14,0,1,15
959471,10/15 08:50 PM,F3A,54,56,0,4,114
959470,10/15 08:50 PM,F5N,0,0,2,0,2
959469,10/15 08:49 PM,F3N,10682,259,0,2,10943
959468,10/15 08:49 PM,F3N,151,312,0,6,469
959467,10/15 08:49 PM,F3N,0,17,0,0,17
959466,10/15 08:49 PM,F3N,193,36,0,2,231
959465,10/15 08:49 PM,F3N,343,263,0,0,606
959464,10/15 08:48 PM,F3N,2,8,0,6,16
959463,10/15 08:47 PM,F3N,3,7,0,53,63
959462,10/15 08:47 PM,F3N,1,1,0,4,6
959461,10/15 08:47 PM,F3N,937,185,0,4,1126
959460,10/15 08:47 PM,F99,0,0,0,0,0
959459,10/15 08:47 PM,F3N,173,74,0,0,247
959458,10/15 08:47 PM,F5N,0,0,2,0,2
959457,10/15 08:46 PM,F3XN,56,3,0,0,59
959456,10/15 08:46 PM,F3XN,8,24,0,40,72
959455,10/15 08:46 PM,F3N,201,181,0,3,385
959454,10/15 08:46 PM,F3N,598,216,0,0,814
959453,10/15 08:46 PM,F3XN,51,99,0,0,150
959452,10/15 08:46 PM,F3XN,2,1,0,0,3
959451,10/15 08:45 PM,F3N,276,197,0,2,475
959450,10/15 08:45 PM,F3N,185,108,0,0,293
959449,10/15 08:45 PM,F24N,0,0,40,1,41
959448,10/15 08:45 PM,F3N,18,6,0,0,24
959447,10/15 08:45 PM,F3N,114,78,0,0,192
959446,10/15 08:44 PM,F3XA,79,16,0,57,152
959445,10/15 08:44 PM,F3N,15,8,0,6,29
959444,10/15 08:44 PM,F5N,0,0,2,0,2
959443,10/15 08:44 PM,F3XN,2,2,0,11,15
959442,10/15 08:44 PM,F5N,0,0,7,0,7
959441,10/15 08:43 PM,F3XN,4,4,0,0,8
959440,10/15 08:42 PM,F3N,0,0,0,3,3
959439,10/15 08:42 PM,F3XN,59,17,0,0,76
959438,10/15 08:41 PM,F3N,81,116,0,1,198
959437,10/15 08:40 PM,F3XN,5,9,0,0,14
959436,10/15 08:40 PM,F3XN,2,0,0,23,25
959435,10/15 08:39 PM,F3N,395,220,0,0,615
959434,10/15 08:39 PM,F3XN,2,13,0,0,15
959433,10/15 08:39 PM,F3XA,13,6,0,12,31
959432,10/15 08:38 PM,F3N,454,125,0,0,579
959431,10/15 08:38 PM,F3N,61,176,0,0,237
959430,10/15 08:37 PM,F5N,0,0,5,0,5
959429,10/15 08:37 PM,F3A,14,33,0,0,47
959428,10/15 08:37 PM,F3XN,1,3,0,0,4
959427,10/15 08:37 PM,F3XN,57,107,0,1,165
959426,10/15 08:36 PM,F3XN,1,9,0,0,10
959425,10/15 08:35 PM,F3N,0,0,0,2,2
959424,10/15 08:35 PM,F3XN,0,0,0,2,2
959423,10/15 08:35 PM,F3N,3,9,0,15,27
959422,10/15 08:34 PM,F3XN,10,15,0,0,25
959421,10/15 08:34 PM,F5N,0,0,2,0,2
959420,10/15 08:34 PM,F3N,0,5,0,0,5
959419,10/15 08:34 PM,F3XT,0,1,0,2,3
959418,10/15 08:34 PM,F3XN,0,0,0,0,0
959417,10/15 08:33 PM,F3A,36,46,0,15,97
959416,10/15 08:33 PM,F3A,126,73,0,0,199
959415,10/15 08:32 PM,F3N,62,63,0,6,131
959414,10/15 08:31 PM,F3N,173,114,0,0,287
959413,10/15 08:31 PM,F3XN,76,9,0,0,85
959412,10/15 08:31 PM,F7N,0,0,0,3,3
959411,10/15 08:31 PM,F3N,89,224,0,0,313
959410,10/15 08:31 PM,F3A,0,1,0,2,3
959409,10/15 08:31 PM,F1N,0,0,0,0,0
959408,10/15 08:30 PM,F3N,500,232,0,0,732
959407,10/15 08:30 PM,F3XN,0,1,0,1,2
959406,10/15 08:29 PM,F3A,12,10,0,14,36
959405,10/15 08:29 PM,F24N,0,0,1,0,1
959404,10/15 08:28 PM,F3XN,24,0,0,54,78
959403,10/15 08:28 PM,F3N,77,164,0,7,248
959402,10/15 08:27 PM,F3XN,1,20,0,0,21
959401,10/15 08:26 PM,F3XN,0,3,0,0,3
959400,10/15 08:25 PM,F3XN,0,0,0,0,0
959399,10/15 08:25 PM,F3N,0,0,0,5,5
959398,10/15 08:24 PM,F3N,0,6,0,7,13
959397,10/15 08:24 PM,F3N,4290,285,0,0,4575
959396,10/15 08:24 PM,F99,0,0,0,0,0
959395,10/15 08:24 PM,F3XN,258,9,0,0,267
959394,10/15 08:24 PM,F3N,1384,165,0,0,1549
959393,10/15 08:23 PM,F3N,0,0,0,1,1
959392,10/15 08:23 PM,F3XN,0,0,0,0,0
959391,10/15 08:23 PM,F3N,311,197,0,2,510
959390,10/15 08:23 PM,F3N,0,21,0,0,21
959389,10/15 08:23 PM,F3N,148,415,0,0,563
959388,10/15 08:22 PM,F3XN,357,11,0,0,368
959387,10/15 08:22 PM,F3XN,301,0,0,0,301
959386,10/15 08:22 PM,F3T,0,0,0,0,0
959385,10/15 08:22 PM,F3XN,21,1,0,0,22
959384,10/15 08:22 PM,F3XN,0,0,0,2,2
959383,10/15 08:22 PM,F3XN,0,0,0,0,0
959382,10/15 08:21 PM,F3N,2,1,0,0,3
959381,10/15 08:20 PM,F24N,0,0,2,0,2
959380,10/15 08:20 PM,F3N,3,13,0,0,16
959379,10/15 08:19 PM,F3N,132,152,0,1,285
959378,10/15 08:18 PM,F3XN,6,0,0,0,6
959377,10/15 08:18 PM,F3XN,119,13,0,0,132
959376,10/15 08:18 PM,F3N,0,1,0,2,3
959375,10/15 08:16 PM,F3N,31,0,0,2,33
959374,10/15 08:16 PM,F3XN,3,8,0,0,11
959373,10/15 08:15 PM,F3XN,9,88,14,0,111
959372,10/15 08:12 PM,F3N,1300,178,0,0,1478
959371,10/15 08:12 PM,F3XN,4,8,0,0,12
959370,10/15 08:11 PM,F3A,138,144,0,5,287
959369,10/15 08:10 PM,F3N,138,140,0,0,278
959368,10/15 08:10 PM,F3XN,1,0,0,0,1
959367,10/15 08:09 PM,F3XN,5,3,0,0,8
959366,10/15 08:08 PM,F3XN,5,1,0,0,6
959365,10/15 08:08 PM,F3XN,76,13,0,0,89
959364,10/15 08:08 PM,F3A,9,0,0,10,19
959363,10/15 08:07 PM,F3XN,0,9,0,0,9
959362,10/15 08:07 PM,F3N,195,135,0,8,338
959361,10/15 08:07 PM,F3N,484,153,0,8,645
959360,10/15 08:06 PM,F3N,2,8,0,6,16
959359,10/15 08:06 PM,F3N,42,103,0,6,151
959358,10/15 08:06 PM,F3N,1,1,0,1,3
959357,10/15 08:05 PM,F3N,6,7,0,0,13
959356,10/15 08:05 PM,F1A,0,0,0,0,0
959355,10/15 08:05 PM,F3XN,1,6,0,0,7
959354,10/15 08:04 PM,F3N,2,14,0,9,25
959353,10/15 08:04 PM,F3XT,2,13,0,0,15
959352,10/15 08:04 PM,F3XN,6,3,0,10,19
959351,10/15 08:03 PM,F3XN,3,1,0,0,4
959350,10/15 08:02 PM,F3XN,0,5,0,0,5
959349,10/15 08:01 PM,F3N,130,81,0,0,211
959348,10/15 08:00 PM,F3XA,3,1,0,0,4
959347,10/15 08:00 PM,F3XN,3,8,26,2,39
959346,10/15 08:00 PM,F3XN,1,1,0,0,2
959345,10/15 08:00 PM,F3N,401,344,0,0,745
959344,10/15 08:00 PM,F3N,193,113,0,0,306
959343,10/15 07:59 PM,F3N,1294,206,0,0,1500
959342,10/15 07:59 PM,F3N,296,61,0,1,358
959341,10/15 07:59 PM,F3N,0,0,0,29,29
959340,10/15 07:59 PM,F3N,636,108,0,0,744
959339,10/15 07:59 PM,F3XN,84,36,0,1,121
959338,10/15 07:59 PM,F3XN,5,1,0,16,22
959337,10/15 07:57 PM,F3N,407,98,0,343,848
959336,10/15 07:56 PM,F3XN,13,1,0,0,14
959335,10/15 07:56 PM,F3XN,113,23,0,0,136
959334,10/15 07:56 PM,F3XN,36,30,0,0,66
959333,10/15 07:56 PM,F3N,12,37,0,1,50
959332,10/15 07:55 PM,F3N,5,57,0,0,62
959331,10/15 07:55 PM,F3N,9,11,0,0,20
959330,10/15 07:55 PM,F24N,0,0,5,0,5
959329,10/15 07:53 PM,F3N,7,25,0,0,32
959328,10/15 07:53 PM,F3XN,1,1,0,0,2
959327,10/15 07:53 PM,F3N,597,77,0,0,674
959326,10/15 07:52 PM,F3N,431,120,0,3,554
959325,10/15 07:52 PM,F3XN,1,11,0,0,12
959324,10/15 07:52 PM,F3N,251,209,0,96,556
959323,10/15 07:52 PM,F3A,2,15,0,0,17
959322,10/15 07:52 PM,F3N,84,61,0,16,161
959321,10/15 07:51 PM,F3N,7,44,0,24,75
959320,10/15 07:51 PM,F3N,12,22,0,0,34
959319,10/15 07:51 PM,F3N,0,26,0,0,26
959318,10/15 07:51 PM,F3N,68,129,0,3,200
959317,10/15 07:51 PM,F3XN,0,0,0,0,0
959316,10/15 07:50 PM,F3N,115,352,0,58,525
959315,10/15 07:50 PM,F3XN,0,8,0,0,8
959314,10/15 07:50 PM,F3XN,3,2,0,0,5
959313,10/15 07:50 PM,F3XN,1,0,0,0,1
959312,10/15 07:49 PM,F3N,1,60,0,0,61
959311,10/15 07:49 PM,F3XN,0,0,0,0,0
959310,10/15 07:48 PM,F3XN,8,1,0,0,9
959309,10/15 07:47 PM,F3N,89,40,0,5,134
959308,10/15 07:47 PM,F99,0,0,0,0,0
959307,10/15 07:47 PM,F3N,387,165,0,0,552
959306,10/15 07:46 PM,F3XN,9,39,0,48,96
959305,10/15 07:45 PM,F3XN,21,4,0,0,25
959304,10/15 07:44 PM,F3XA,2,2,0,0,4
959303,10/15 07:44 PM,F3N,6314,296,0,0,6610
959302,10/15 07:43 PM,F3XT,2,13,0,0,15
959301,10/15 07:43 PM,F3XN,2,0,0,0,2
959300,10/15 07:42 PM,F3N,305,247,0,0,552
959299,10/15 07:42 PM,F3N,711,389,0,6,1106
959298,10/15 07:42 PM,F3XN,131,25,0,1,157
959297,10/15 07:41 PM,F3N,195,237,0,0,432
959296,10/15 07:39 PM,F3XN,63,2406,727,0,3196
959295,10/15 07:37 PM,F3A,351,69,0,18,438
959294,10/15 07:37 PM,F3N,3596,490,0,0,4086
959293,10/15 07:36 PM,F3N,9,7,0,1,17
959292,10/15 07:35 PM,F3N,3,31,0,11,45
959291,10/15 07:35 PM,F3N,300,218,0,1,519
959290,10/15 07:33 PM,F3N,193,179,0,0,372
959289,10/15 07:32 PM,F3N,0,0,0,3,3
959288,10/15 07:32 PM,F3XN,8,1,0,0,9
959287,10/15 07:32 PM,F3XA,0,0,0,0,0
959286,10/15 07:32 PM,F3N,74,110,0,0,184
959285,10/15 07:30 PM,F3XN,0,2,0,0,2
959284,10/15 07:30 PM,F3N,3,8,0,3,14
959283,10/15 07:29 PM,F3N,0,62,0,1,63
959282,10/15 07:29 PM,F24N,0,0,46,0,46
959281,10/15 07:29 PM,F3N,752,201,0,10,963
959280,10/15 07:28 PM,F3XN,46,71,0,1,118
959279,10/15 07:28 PM,F3N,3,18,0,17,38
959278,10/15 07:27 PM,F3A,19,56,0,2,77
959277,10/15 07:26 PM,F3XN,0,1,0,20,21
959276,10/15 07:26 PM,F3N,97,117,0,3,217
959275,10/15 07:25 PM,F3XN,0,1,0,0,1
959274,10/15 07:24 PM,F3XN,9,6,0,0,15
959273,10/15 07:24 PM,F3N,215,227,0,2,444
959272,10/15 07:24 PM,F3A,303,167,0,4,474
959271,10/15 07:23 PM,F3N,181,102,0,0,283
959270,10/15 07:22 PM,F3XN,1,1,0,0,2
959269,10/15 07:21 PM,F3N,0,0,0,0,0
959268,10/15 07:21 PM,F3N,2,14,0,5,21
959267,10/15 07:21 PM,F3A,82,52,0,3,137
959266,10/15 07:21 PM,F3N,3288,495,0,3,3786
959265,10/15 07:20 PM,F3XN,37,4,0,0,41
959264,10/15 07:18 PM,F3N,56,36,0,1,93
959263,10/15 07:18 PM,F3XN,445,34,45,7,531
959262,10/15 07:17 PM,F3XN,73,18,0,0,91
959261,10/15 07:16 PM,F3N,70,41,0,0,111
959260,10/15 07:16 PM,F99,0,0,0,0,0
959259,10/15 07:15 PM,F3N,248,177,0,7,432
959258,10/15 07:15 PM,F3XN,3,1,0,35,39
959257,10/15 07:15 PM,F3N,3,13,0,2,18
959256,10/15 07:14 PM,F3XN,784,44,0,4,832
959255,10/15 07:14 PM,F3XA,2,3,0,33,38
959254,10/15 07:14 PM,F99,0,0,0,0,0
959253,10/15 07:14 PM,F3N,179,172,0,1,352
959252,10/15 07:13 PM,F3N,117,102,0,0,219
959251,10/15 07:13 PM,F3XN,11,117,0,0,128
959250,10/15 07:12 PM,F3XN,0,0,0,0,0
959249,10/15 07:12 PM,F3A,8,60,0,29,97
959248,10/15 07:12 PM,F3XN,0,0,0,0,0
959247,10/15 07:12 PM,F3XN,16,26,0,0,42
959246,10/15 07:11 PM,F3XN,0,0,0,0,0
959245,10/15 07:11 PM,F3N,1490,268,0,0,1758
959244,10/15 07:10 PM,F3A,38,59,0,18,115
959243,10/15 07:10 PM,F3N,0,17,0,0,17
959242,10/15 07:10 PM,F3N,193,100,0,8,301
959241,10/15 07:09 PM,F3N,139,72,0,2,213
959240,10/15 07:08 PM,F3A,19,63,0,11,93
959239,10/15 07:08 PM,F3N,0,0,0,0,0
959238,10/15 07:08 PM,F3XN,371,139,22,9,541
959237,10/15 07:08 PM,F3XN,0,0,0,0,0
959236,10/15 07:07 PM,F3XN,10,8,0,0,18
959235,10/15 07:07 PM,F3N,343,258,0,0,601
959234,10/15 07:07 PM,F3N,428,148,0,1,577
959233,10/15 07:07 PM,F3XA,0,1,0,0,1
959232,10/15 07:06 PM,F1N,0,0,0,0,0
959231,10/15 07:06 PM,F3N,4,78,0,0,82
959230,10/15 07:05 PM,F3N,119,313,0,2,434
959229,10/15 07:03 PM,F3N,405,190,0,0,595
959228,10/15 07:03 PM,F3N,16,43,0,3,62
959227,10/15 07:03 PM,F3XN,10,19,0,9,38
959226,10/15 07:02 PM,F1N,0,0,0,0,0
959225,10/15 07:02 PM,F3N,81,86,0,3,170
959224,10/15 07:02 PM,F3N,555,152,0,7,714
959223,10/15 07:02 PM,F3N,121,72,0,0,193
959222,10/15 07:01 PM,F3N,97,127,0,7,231
959221,10/15 07:01 PM,F3N,742,215,0,0,957
959220,10/15 07:00 PM,F3N,260,201,0,2,463
959219,10/15 07:00 PM,F3A,54,25,0,3,82
959218,10/15 06:58 PM,F3XN,0,2,0,2,4
959217,10/15 06:58 PM,F3XN,189,113,0,0,302
959216,10/15 06:57 PM,F1N,0,0,0,0,0
959215,10/15 06:57 PM,F3N,8,48,0,8,64
959214,10/15 06:55 PM,F3XN,77,37,0,0,114
959213,10/15 06:55 PM,F3XN,5,5,0,0,10
959212,10/15 06:55 PM,F3N,234,174,0,9,417
959211,10/15 06:54 PM,F3N,66,97,0,0,163
959210,10/15 06:54 PM,F3XN,2,0,0,13,15
959209,10/15 06:53 PM,F3N,205,100,0,9,314
959208,10/15 06:53 PM,F3XN,6,6,0,0,12
959207,10/15 06:53 PM,F3XN,2643,142,0,1,2786
959206,10/15 06:52 PM,F3XN,11,26,0,0,37
959205,10/15 06:52 PM,F3XN,9,2,0,0,11
959204,10/15 06:51 PM,F3XN,305,61,0,0,366
959203,10/15 06:51 PM,F3N,476,99,0,5,580
959202,10/15 06:51 PM,F3N,121,179,0,0,300
959201,10/15 06:50 PM,F1N,0,0,0,0,0
959200,10/15 06:50 PM,F3N,788,406,0,1,1195
959199,10/15 06:48 PM,F2A,0,0,0,0,0
959198,10/15 06:48 PM,F3N,695,217,0,6,918
959197,10/15 06:48 PM,F3N,710,166,0,0,876
959196,10/15 06:48 PM,F3N,112,90,0,1,203
959195,10/15 06:47 PM,F3XN,11,4,0,0,15
959194,10/15 06:46 PM,F3N,91,65,0,10,166
959193,10/15 06:45 PM,F3XN,0,0,0,0,0
959192,10/15 06:45 PM,F3N,1,0,0,7,8
959191,10/15 06:45 PM,F1N,0,0,0,0,0
959190,10/15 06:44 PM,F1A,0,0,0,0,0
959189,10/15 06:43 PM,F3N,122,114,0,0,236
959188,10/15 06:43 PM,F3XN,1,3,0,0,4
959187,10/15 06:42 PM,F3XN,12,1,0,0,13
959186,10/15 06:42 PM,F3N,26,167,0,53,246
959185,10/15 06:42 PM,F3XN,35,61,0,0,96
959184,10/15 06:41 PM,F3N,42,79,0,5,126
959183,10/15 06:41 PM,F3XN,0,21,0,1,22
959182,10/15 06:41 PM,F3XN,0,33,0,0,33
959181,10/15 06:40 PM,F3XN,36,3,0,0,39
959180,10/15 06:39 PM,F3N,99,71,0,1,171
959179,10/15 06:39 PM,F3N,90,66,0,0,156
959178,10/15 06:39 PM,F3N,61,67,0,0,128
959177,10/15 06:39 PM,F24N,0,0,17,0,17
959176,10/15 06:38 PM,F3XN,0,0,0,0,0
959175,10/15 06:38 PM,F3XN,2,59,0,1,62
959174,10/15 06:35 PM,F3N,217,215,0,6,438
959173,10/15 06:35 PM,F3XN,761,47,0,0,808
959172,10/15 06:35 PM,F3XN,31,10,0,0,41
959171,10/15 06:34 PM,F3N,199,138,0,4,341
959170,10/15 06:34 PM,F3N,0,0,0,0,0
959169,10/15 06:34 PM,F3A,2,12,0,18,32
959168,10/15 06:33 PM,F3N,93,81,0,0,174
959167,10/15 06:33 PM,F3N,604,184,0,16,804
959166,10/15 06:32 PM,F3XN,4,4,0,0,8
959165,10/15 06:32 PM,F3N,40,101,0,6,147
959164,10/15 06:32 PM,F3A,4,30,0,12,46
959163,10/15 06:31 PM,F3XN,17,23,0,3,43
959162,10/15 06:31 PM,F3N,218,89,0,15,322
959161,10/15 06:31 PM,F3N,0,9,0,5,14
959160,10/15 06:30 PM,F3XN,9,16,1,0,26
959159,10/15 06:30 PM,F3A,7,16,0,14,37
959158,10/15 06:29 PM,F3XN,100,19,0,0,119
959157,10/15 06:28 PM,F3N,659,454,0,2,1115
959156,10/15 06:28 PM,F3N,0,0,0,0,0
959155,10/15 06:27 PM,F3N,1,1,0,18,20
959154,10/15 06:27 PM,F3PN,6,36,0,117,159
959153,10/15 06:26 PM,F3XN,0,0,0,0,0
959152,10/15 06:26 PM,F3N,16,10,0,0,26
959151,10/15 06:26 PM,F3A,4,22,0,9,35
959150,10/15 06:25 PM,F3N,547,291,0,3,841
959149,10/15 06:25 PM,F3N,1735,371,0,0,2106
959148,10/15 06:25 PM,F3N,411,199,0,0,610
959147,10/15 06:25 PM,F24N,0,0,1,0,1
959146,10/15 06:25 PM,F3XN,363,261,0,60,684
959145,10/15 06:24 PM,F3N,0,0,0,1,1
959144,10/15 06:24 PM,F3A,0,14,0,5,19
959143,10/15 06:24 PM,F3A,8,22,0,6,36
959142,10/15 06:23 PM,F3N,43,33,0,3,79
959141,10/15 06:23 PM,F3N,278,172,0,0,450
959140,10/15 06:23 PM,F3XN,34,106,0,0,140
959139,10/15 06:23 PM,F3XN,0,0,0,0,0
959138,10/15 06:22 PM,F3A,5,14,0,8,27
959137,10/15 06:22 PM,F3N,223,78,0,0,301
959136,10/15 06:22 PM,F3XN,3,10,0,0,13
959135,10/15 06:22 PM,F3A,293,325,0,2,620
959134,10/15 06:22 PM,F3A,2,80,0,5,87
959133,10/15 06:21 PM,F3N,115,127,0,19,261
959132,10/15 06:21 PM,F3N,1727,165,0,1,1893
959131,10/15 06:21 PM,F3N,201,113,0,0,314
959130,10/15 06:21 PM,F3N,1892,290,0,0,2182
959129,10/15 06:21 PM,F3A,2,1,0,3,6
959128,10/15 06:20 PM,F3N,311,206,0,0,517
959127,10/15 06:20 PM,F3XN,11,4,0,0,15
959126,10/15 06:20 PM,F3N,1701,202,0,17,1920
959125,10/15 06:19 PM,F3XN,3,21,0,0,24
959124,10/15 06:19 PM,F3XN,0,0,0,0,0
959123,10/15 06:19 PM,F3XA,7,9,0,0,16
959122,10/15 06:19 PM,F3A,73,56,0,5,134
959121,10/15 06:18 PM,F3N,301,115,0,7,423
959120,10/15 06:17 PM,F3XN,91,33,0,0,124
959119,10/15 06:17 PM,F3N,3,34,0,10,47
959118,10/15 06:17 PM,F3N,874,91,0,0,965
959117,10/15 06:16 PM,F3XN,57,37,0,0,94
959116,10/15 06:16 PM,F3XN,0,0,0,0,0
959115,10/15 06:16 PM,F3A,334,182,0,0,516
959114,10/15 06:16 PM,F3XN,2,10,1,0,13
959113,10/15 06:16 PM,F3XN,3,0,0,0,3
959112,10/15 06:15 PM,F3N,166,261,0,3,430
959111,10/15 06:15 PM,F3N,28,38,0,1,67
959110,10/15 06:15 PM,F3A,4,30,0,12,46
959109,10/15 06:15 PM,F3XN,18,26,0,0,44
959108,10/15 06:14 PM,F24N,0,0,2,0,2
959107,10/15 06:14 PM,F3XN,8,1,0,5,14
959106,10/15 06:14 PM,F3XN,435,15,0,0,450
959105,10/15 06:14 PM,F3N,5,7,0,0,12
959104,10/15 06:14 PM,F3XN,45,6,0,0,51
959103,10/15 06:13 PM,F3N,127,171,0,3,301
959102,10/15 06:13 PM,F3N,192,97,0,2,291
959101,10/15 06:13 PM,F3XN,0,5,0,0,5
959100,10/15 06:13 PM,F3N,180,100,0,1,281
959099,10/15 06:12 PM,F3XN,0,8,0,0,8
959098,10/15 06:12 PM,F3N,359,145,0,0,504
959097,10/15 06:12 PM,F3N,60,51,0,0,111
959096,10/15 06:12 PM,F3A,7,16,0,14,37
959095,10/15 06:12 PM,F3XN,78,22,0,77,177
959094,10/15 06:11 PM,F3A,179,74,0,0,253
959093,10/15 06:11 PM,F3XN,0,0,0,0,0
959092,10/15 06:11 PM,F3A,124,78,0,7,209
959091,10/15 06:11 PM,F3XN,1,28,0,0,29
959090,10/15 06:11 PM,F3N,98,165,0,0,263
959089,10/15 06:10 PM,F3XA,4,3,0,0,7
959088,10/15 06:09 PM,F3N,6,6,0,6,18
959087,10/15 06:09 PM,F3XA,9,5,0,0,14
959086,10/15 06:09 PM,F3A,4,22,0,9,35
959085,10/15 06:09 PM,F3N,148,181,0,10,339
959084,10/15 06:08 PM,F3A,59,47,0,5,111
959083,10/15 06:08 PM,F3XA,0,0,0,0,0
959082,10/15 06:08 PM,F3A,154,68,0,0,222
959081,10/15 06:08 PM,F3N,138,35,0,6,179
959080,10/15 06:08 PM,F3N,19,71,0,7,97
959079,10/15 06:08 PM,F3N,5,21,0,4,30
959078,10/15 06:07 PM,F1A,0,0,0,0,0
959077,10/15 06:07 PM,F3N,0,0,0,3,3
959076,10/15 06:06 PM,F3N,43,28,0,3,74
959075,10/15 06:06 PM,F3N,120,163,0,0,283
959074,10/15 06:06 PM,F3N,607,193,0,34,834
959073,10/15 06:06 PM,F3XN,4,10,0,1,15
959072,10/15 06:06 PM,F3XN,21,8,0,15,44
959071,10/15 06:05 PM,F3XN,0,4,0,3,7
959070,10/15 06:05 PM,F3N,68,142,0,2,212
959069,10/15 06:05 PM,F3N,4095,212,0,0,4307
959068,10/15 06:04 PM,F3N,63,84,0,0,147
959067,10/15 06:04 PM,F3XA,49,13,0,0,62
959066,10/15 06:04 PM,F3XN,58,7,0,0,65
959065,10/15 06:04 PM,F24N,0,0,2,0,2
959064,10/15 06:03 PM,F3XN,0,1,0,0,1
959063,10/15 06:03 PM,F3N,2,13,0,4,19
959062,10/15 06:03 PM,F3A,105,190,0,12,307
959061,10/15 06:03 PM,F99,0,0,0,0,0
959060,10/15 06:03 PM,F3XA,37,10,0,0,47
959059,10/15 06:03 PM,F3A,8,22,0,6,36
959058,10/15 06:02 PM,F3XN,0,1,0,0,1
959057,10/15 06:02 PM,F3N,341,157,0,0,498
959056,10/15 06:00 PM,F3N,102,52,0,0,154
959055,10/15 06:00 PM,F3XN,61,27,0,0,88
959054,10/15 05:59 PM,F3A,45,27,0,5,77
959053,10/15 05:59 PM,F3N,49,46,0,0,95
959052,10/15 05:59 PM,F3N,0,0,0,12,12
959051,10/15 05:59 PM,F3N,129,150,0,0,279
959050,10/15 05:59 PM,F3XA,95,14,0,1,110
959049,10/15 05:59 PM,F5N,8,0,27,0,35
959048,10/15 05:58 PM,F3XN,0,9,0,0,9
959047,10/15 05:58 PM,F3N,0,0,0,2,2
959046,10/15 05:58 PM,F3XA,32,22,0,0,54
959045,10/15 05:57 PM,F3XN,70,42,31,88,231
959044,10/15 05:57 PM,F3A,5,14,0,8,27
959043,10/15 05:56 PM,F3N,150,188,0,1,339
959042,10/15 05:56 PM,F3N,0,0,0,1,1
959041,10/15 05:56 PM,F3N,597,68,0,0,665
959040,10/15 05:56 PM,F3A,10,18,0,5,33
959039,10/15 05:56 PM,F3XA,123,25,0,0,148
959038,10/15 05:56 PM,F3XN,70,74,0,0,144
959037,10/15 05:56 PM,F3XN,0,0,0,0,0
959036,10/15 05:55 PM,F3N,1222,163,0,3,1388
959035,10/15 05:55 PM,F3N,609,205,0,5,819
959034,10/15 05:55 PM,F3A,33,19,0,0,52
959033,10/15 05:55 PM,F3XN,348,2,0,0,350
959032,10/15 05:54 PM,F3N,368,189,0,0,557
959031,10/15 05:54 PM,F3XA,43,15,0,1,59
959030,10/15 05:54 PM,F3XN,23,10,0,0,33
959029,10/15 05:54 PM,F3XN,0,0,0,1,1
959028,10/15 05:53 PM,F3XN,617,121,0,1,739
959027,10/15 05:53 PM,F5A,8,0,24,0,32
959026,10/15 05:52 PM,F24N,0,0,2,0,2
959025,10/15 05:52 PM,F3N,0,1,0,0,1
959024,10/15 05:52 PM,F3N,0,0,0,2,2
959023,10/15 05:52 PM,F3N,46,60,0,5,111
959022,10/15 05:52 PM,F3N,18,34,0,2,54
959021,10/15 05:52 PM,F3XN,210,85,0,0,295
959020,10/15 05:51 PM,F3XN,16,23,3,0,42
959019,10/15 05:51 PM,F5N,0,0,9,0,9
959018,10/15 05:51 PM,F3XN,2,11,0,0,13
959017,10/15 05:51 PM,F3XN,20,0,0,3,23
959016,10/15 05:51 PM,F3XN,8,32,0,0,40
959015,10/15 05:50 PM,F3A,57,40,0,6,103
959014,10/15 05:50 PM,F3XN,1,5,0,0,6
959013,10/15 05:50 PM,F3XN,378,11,0,0,389
959012,10/15 05:50 PM,F5N,0,0,67,0,67
959011,10/15 05:49 PM,F3XA,296,66,0,1,363
959010,10/15 05:49 PM,F3XN,18,17,0,0,35
959009,10/15 05:49 PM,F3N,319,309,0,0,628
959008,10/15 05:48 PM,F3XN,8,14,0,0,22
959007,10/15 05:48 PM,F3XN,0,0,0,0,0
959006,10/15 05:48 PM,F5N,0,0,1,0,1
959005,10/15 05:47 PM,F3XN,2,7,0,4,13
959004,10/15 05:47 PM,F3N,1145,185,0,0,1330
959003,10/15 05:47 PM,F3XN,3,6,0,0,9
959002,10/15 05:47 PM,F3XN,0,8,0,4,12
959001,10/15 05:47 PM,F3A,167,76,0,2,245
959000,10/15 05:46 PM,F3XA,159,13,0,1,173
958999,10/15 05:46 PM,F3XN,4,1,0,0,5
958998,10/15 05:46 PM,F3N,414,151,0,0,565
958997,10/15 05:46 PM,F3N,421,40,0,0,461
958996,10/15 05:45 PM,F3XN,8,8,0,1,17
958995,10/15 05:45 PM,F3XN,1,4,0,0,5
958994,10/15 05:45 PM,F3XN,0,4,0,0,4
958993,10/15 05:44 PM,F3N,565,86,0,2,653
958992,10/15 05:44 PM,F3XN,38,48,0,0,86
958991,10/15 05:44 PM,F3XN,25,21,0,4,50
958990,10/15 05:44 PM,F3N,0,16,0,2,18
958989,10/15 05:44 PM,F3XN,3,1,0,0,4
958988,10/15 05:43 PM,F3XN,13,3,0,10,26
958987,10/15 05:43 PM,F3XN,11,2,0,0,13
958986,10/15 05:43 PM,F3XN,7,18,0,0,25
958985,10/15 05:42 PM,F3XA,4,12,0,1,17
958984,10/15 05:42 PM,F3N,229,157,0,9,395
958983,10/15 05:42 PM,F3N,5,4,0,0,9
958982,10/15 05:42 PM,F1N,0,0,0,0,0
958981,10/15 05:42 PM,F3XN,383,29,0,0,412
958980,10/15 05:42 PM,F3A,112,37,0,5,154
958979,10/15 05:41 PM,F3XN,2,8,0,0,10
958978,10/15 05:41 PM,F3N,109,194,0,0,303
958977,10/15 05:41 PM,F3N,9,18,0,6,33
958976,10/15 05:40 PM,F3N,74,92,0,0,166
958975,10/15 05:40 PM,F3N,176,44,0,0,220
958974,10/15 05:40 PM,F3N,92,125,0,0,217
958973,10/15 05:40 PM,F3N,0,0,0,3,3
958972,10/15 05:40 PM,F3XN,4,9,0,0,13
958971,10/15 05:39 PM,F3N,4,4,0,3,11
958970,10/15 05:39 PM,F3XA,86,2,0,0,88
958969,10/15 05:39 PM,F3N,1107,154,0,0,1261
958968,10/15 05:39 PM,F3N,542,86,0,0,628
958967,10/15 05:38 PM,F99,0,0,0,0,0
958966,10/15 05:38 PM,F3XN,78,93,14,0,185
958965,10/15 05:37 PM,F3N,2,6,0,0,8
958964,10/15 05:37 PM,F3N,179,117,0,2,298
958963,10/15 05:37 PM,F3XN,298,30,0,0,328
958962,10/15 05:36 PM,F3XN,628,268,0,0,896
958961,10/15 05:36 PM,F3XN,556,135,0,0,691
958960,10/15 05:36 PM,F3A,29,33,0,1,63
958959,10/15 05:36 PM,F3XT,0,1,0,0,1
958958,10/15 05:35 PM,F3XN,95,11,0,1,107
958957,10/15 05:35 PM,F3XN,38,2,0,0,40
958956,10/15 05:35 PM,F5N,0,0,2,0,2
958955,10/15 05:34 PM,F3N,0,1,0,7,8
958954,10/15 05:34 PM,F3N,605,144,0,0,749
958953,10/15 05:34 PM,F3XN,29,5,0,0,34
958952,10/15 05:34 PM,F3N,69,131,0,2,202
958951,10/15 05:33 PM,F3T,4,13,0,5,22
958950,10/15 05:33 PM,F3XA,96,13,0,1,110
958949,10/15 05:32 PM,F3N,1878,147,0,2,2027
958948,10/15 05:32 PM,F3N,0,0,0,12,12
958947,10/15 05:32 PM,F3XN,0,15,0,0,15
958946,10/15 05:31 PM,F7N,0,0,0,39,39
958945,10/15 05:31 PM,F24N,0,0,2,0,2
958944,10/15 05:31 PM,F3N,41,29,0,15,85
958943,10/15 05:31 PM,F3XN,86,13,0,0,99
958942,10/15 05:31 PM,F3T,0,0,0,0,0
958941,10/15 05:31 PM,F3XN,0,0,0,0,0
958940,10/15 05:31 PM,F3XN,0,1,0,0,1
958939,10/15 05:31 PM,F3A,93,85,0,0,178
958938,10/15 05:30 PM,F3T,0,4,0,0,4
958937,10/15 05:30 PM,F5N,0,0,22,0,22
958936,10/15 05:30 PM,F3XN,0,0,0,0,0
958935,10/15 05:30 PM,F3XN,0,0,0,0,0
958934,10/15 05:30 PM,F4N,2,90,0,0,92
958933,10/15 05:29 PM,F3XN,4,3,2,3,12
958932,10/15 05:29 PM,F3N,312,85,0,10,407
958931,10/15 05:29 PM,F3A,147,73,0,4,224
958930,10/15 05:29 PM,F3XN,0,1,0,0,1
958929,10/15 05:29 PM,F3XA,55,75,0,1,131
958928,10/15 05:29 PM,F3N,0,0,0,12,12
958927,10/15 05:29 PM,F3N,50,30,0,0,80
958926,10/15 05:28 PM,F3XN,0,0,0,5,5
958925,10/15 05:28 PM,F3XN,82,13,0,0,95
958924,10/15 05:28 PM,F3XN,0,0,0,9,9
958923,10/15 05:28 PM,F3N,240,241,0,0,481
958922,10/15 05:28 PM,F3XN,0,0,0,0,0
958921,10/15 05:28 PM,F3XN,8,16,0,0,24
958920,10/15 05:28 PM,F3XA,146,8,0,0,154
958919,10/15 05:28 PM,F3XN,4,48,0,0,52
958918,10/15 05:28 PM,F3XN,0,1,0,0,1
958917,10/15 05:28 PM,F3N,54,99,0,6,159
958916,10/15 05:27 PM,F3N,233,148,0,1,382
958915,10/15 05:27 PM,F3N,79,58,0,11,148
958914,10/15 05:27 PM,F3XN,131,17,0,0,148
958913,10/15 05:26 PM,F3N,706,279,0,0,985
958912,10/15 05:26 PM,F3XN,0,0,0,0,0
958911,10/15 05:26 PM,F3XN,140,7,0,0,147
958910,10/15 05:25 PM,F3XN,2,1,0,0,3
958909,10/15 05:25 PM,F3N,1334,240,0,0,1574
958908,10/15 05:25 PM,F3N,1529,167,0,9,1705
958907,10/15 05:25 PM,F3XN,73,41,0,0,114
958906,10/15 05:25 PM,F3XN,0,1,0,0,1
958905,10/15 05:24 PM,F3N,94,88,0,0,182
958904,10/15 05:24 PM,F3N,0,19,0,2,21
958903,10/15 05:24 PM,F3XN,21,3,0,0,24
958902,10/15 05:23 PM,F3XN,0,2,0,0,2
958901,10/15 05:23 PM,F3XN,85,6,0,0,91
958900,10/15 05:23 PM,F3N,21,72,0,32,125
958899,10/15 05:23 PM,F3XN,8,21,0,0,29
958898,10/15 05:23 PM,F3XN,14,18,0,0,32
958897,10/15 05:22 PM,F24N,0,0,2,0,2
958896,10/15 05:22 PM,F3T,0,2,0,0,2
958895,10/15 05:22 PM,F3XN,3,8,1,0,12
958894,10/15 05:22 PM,F3N,11,156,0,30,197
958893,10/15 05:22 PM,F3XN,7,11,0,0,18
958892,10/15 05:22 PM,F3N,0,0,0,23,23
958891,10/15 05:22 PM,F3XA,4195,498,23,2,4718
958890,10/15 05:21 PM,F3XA,79,10,0,0,89
958889,10/15 05:21 PM,F3N,84,161,0,0,245
958888,10/15 05:21 PM,F3XN,0,1,1,0,2
958887,10/15 05:20 PM,F3XN,0,0,0,0,0
958886,10/15 05:20 PM,F3N,600,192,0,5,797
958885,10/15 05:20 PM,F3XA,92,9,0,0,101
958884,10/15 05:19 PM,F3N,375,123,0,1,499
958883,10/15 05:19 PM,F3N,249,219,0,1,469
958882,10/15 05:18 PM,F3XN,39,57,0,1,97
958881,10/15 05:18 PM,F3XA,60,9,0,0,69
958880,10/15 05:18 PM,F3N,345,172,0,0,517
958879,10/15 05:18 PM,F3N,0,8,0,0,8
958878,10/15 05:18 PM,F3N,269,65,0,5,339
958877,10/15 05:17 PM,F3XA,46,11,0,0,57
958876,10/15 05:17 PM,F3N,141,117,0,1,259
958875,10/15 05:17 PM,F3XN,8,13,0,5,26
958874,10/15 05:17 PM,F3XN,0,2,0,1,3
958873,10/15 05:16 PM,F3XA,47,12,0,0,59
958872,10/15 05:16 PM,F3N,0,0,0,19,19
958871,10/15 05:16 PM,F3N,1372,394,0,2,1768
958870,10/15 05:16 PM,F3N,67,39,0,2,108
958869,10/15 05:15 PM,F3N,10,11,0,4,25
958868,10/15 05:15 PM,F3XN,1,0,0,0,1
958867,10/15 05:15 PM,F3XA,55,6,0,0,61
958866,10/15 05:15 PM,F3N,248,169,0,9,426
958865,10/15 05:15 PM,F3XN,0,1,0,0,1
958864,10/15 05:14 PM,F3XN,3,0,0,0,3
958863,10/15 05:14 PM,F3XN,135,29,0,0,164
958862,10/15 05:14 PM,F3N,110,30,0,4,144
958861,10/15 05:13 PM,F24N,0,0,4,0,4
958860,10/15 05:13 PM,F3XN,0,1,0,0,1
958859,10/15 05:13 PM,F3N,43,50,0,20,113
958858,10/15 05:13 PM,F3T,0,0,0,0,0
958857,10/15 05:13 PM,F3XN,259,49,0,0,308
958856,10/15 05:13 PM,F3XN,7,8,0,0,15
958855,10/15 05:13 PM,F3N,2,11,0,0,13
958854,10/15 05:13 PM,F3XN,658,3,0,0,661
958853,10/15 05:12 PM,F3N,0,2,0,2,4
958852,10/15 05:11 PM,F3XN,0,6,0,8,14
958851,10/15 05:11 PM,F3N,1243,254,0,0,1497
958850,10/15 05:11 PM,F3XN,55,14,0,0,69
958849,10/15 05:11 PM,F3N,69,37,0,0,106
958848,10/15 05:09 PM,F3XN,35,13,0,5,53
958847,10/15 05:09 PM,F3XN,2,18,0,0,20
958846,10/15 05:09 PM,F3XN,769,82,0,0,851
958845,10/15 05:08 PM,F3XN,0,2,0,0,2
958844,10/15 05:07 PM,F3N,372,545,0,0,917
958843,10/15 05:07 PM,F3XN,23,38,0,0,61
958842,10/15 05:07 PM,F3XN,4,0,3,0,7
958841,10/15 05:07 PM,F3XN,0,0,0,3,3
958840,10/15 05:07 PM,F3N,32,30,0,2,64
958839,10/15 05:07 PM,F3XN,143,31,0,0,174
958838,10/15 05:06 PM,F3N,10,59,0,3,72
958837,10/15 05:06 PM,F3N,145,65,0,0,210
958836,10/15 05:06 PM,F3XN,0,7,0,0,7
958835,10/15 05:06 PM,F3XN,7,5,1,0,13
958834,10/15 05:06 PM,F3N,179,143,0,6,328
958833,10/15 05:06 PM,F3N,0,0,0,0,0
958832,10/15 05:06 PM,F3N,0,0,0,1,1
958831,10/15 05:05 PM,F3XA,48,6,0,0,54
958830,10/15 05:05 PM,F3XN,124,0,0,1,125
958829,10/15 05:04 PM,F3N,718,227,0,0,945
958828,10/15 05:04 PM,F3N,133,69,0,1,203
958827,10/15 05:04 PM,F24N,0,0,2,0,2
958826,10/15 05:04 PM,F3N,2909,261,0,1,3171
958825,10/15 05:03 PM,F3N,703,116,0,1,820
958824,10/15 05:03 PM,F3N,0,0,0,1,1
958823,10/15 05:02 PM,F3N,30,58,0,0,88
958822,10/15 05:02 PM,F3N,6,5,0,0,11
958821,10/15 05:02 PM,F3XA,72,3,0,1,76
958820,10/15 05:02 PM,F3N,440,210,0,0,650
958819,10/15 05:02 PM,F3XN,0,0,0,0,0
958818,10/15 05:02 PM,F3N,0,2,0,81,83
958817,10/15 05:01 PM,F3XA,12,5,0,0,17
958816,10/15 05:01 PM,F3N,116,116,0,1,233
958815,10/15 05:01 PM,F3XN,3,1,0,0,4
958814,10/15 05:01 PM,F3N,429,340,0,9,778
958813,10/15 05:01 PM,F3XN,5,6,0,0,11
958812,10/15 05:00 PM,F3N,169,74,0,0,243
958811,10/15 05:00 PM,F3XN,0,7,0,1,8
958810,10/15 05:00 PM,F3XN,685,125,0,0,810
958809,10/15 05:00 PM,F3PN,0,7,0,64,71
958808,10/15 04:59 PM,F3N,1173,208,0,7,1388
958807,10/15 04:59 PM,F3XN,8,35,0,0,43
958806,10/15 04:59 PM,F3N,268,176,0,0,444
958805,10/15 04:58 PM,F3N,187,126,0,0,313
958804,10/15 04:58 PM,F3N,100,83,0,0,183
958803,10/15 04:58 PM,F3N,5,12,0,0,17
958802,10/15 04:58 PM,F3A,200,103,0,1,304
958801,10/15 04:57 PM,F3XN,0,0,0,6,6
958800,10/15 04:57 PM,F3XN,0,0,0,18,18
958799,10/15 04:57 PM,F3N,336,156,0,0,492
958798,10/15 04:57 PM,F3N,71,175,0,1,247
958797,10/15 04:57 PM,F3XN,108,56,0,0,164
958796,10/15 04:56 PM,F3N,2,2,0,2,6
958795,10/15 04:56 PM,F3XN,0,2,0,0,2
958794,10/15 04:56 PM,F5N,0,0,2,0,2
958793,10/15 04:56 PM,F3XN,0,2,0,0,2
958792,10/15 04:56 PM,F3N,955,368,0,0,1323
958791,10/15 04:55 PM,F3XA,3,8,0,0,11
958790,10/15 04:55 PM,F3N,0,3,0,4,7
958789,10/15 04:55 PM,F1A,0,0,0,0,0
958788,10/15 04:55 PM,F3XN,19115,12,0,1,19128
958787,10/15 04:54 PM,F3XN,0,10,0,0,10
958786,10/15 04:54 PM,F3N,2,8,0,39,49
958785,10/15 04:54 PM,F3XN,426,15,0,0,441
958784,10/15 04:54 PM,F3XN,0,5,0,0,5
958783,10/15 04:54 PM,F3XN,3,17,0,0,20
958782,10/15 04:53 PM,F1MN,0,0,0,0,0
958781,10/15 04:53 PM,F3XA,1,13,0,0,14
958780,10/15 04:53 PM,F3N,0,2,0,2,4
958779,10/15 04:53 PM,F3N,18,56,0,2,76
958778,10/15 04:53 PM,F3XN,0,0,0,0,0
958777,10/15 04:52 PM,F3XN,29,23,0,0,52
958776,10/15 04:51 PM,F3XN,7,16,1,0,24
958775,10/15 04:51 PM,F3XN,683,35,0,2,720
958774,10/15 04:51 PM,F3XN,1,10,0,0,11
958773,10/15 04:51 PM,F3A,212,56,0,3,271
958772,10/15 04:51 PM,F3XA,0,12,0,0,12
958771,10/15 04:51 PM,F3XN,24,5,0,0,29
958770,10/15 04:51 PM,F3XN,5,15,0,0,20
958769,10/15 04:50 PM,F3N,1512,228,0,0,1740
958768,10/15 04:50 PM,F3A,12,18,0,0,30
958767,10/15 04:50 PM,F3N,0,5,0,8,13
958766,10/15 04:50 PM,F3N,0,0,0,12,12
958765,10/15 04:50 PM,F3XN,37,81,0,78,196
958764,10/15 04:49 PM,F3XN,4,10,1,0,15
958763,10/15 04:49 PM,F3XN,47,64,10,5,126
958762,10/15 04:49 PM,F3XT,85,22,0,0,107
958761,10/15 04:48 PM,F3N,3,61,0,22,86
958760,10/15 04:48 PM,F3N,0,1,0,0,1
958759,10/15 04:47 PM,F3XA,31,3,0,1,35
958758,10/15 04:47 PM,F3XN,67,29,0,0,96
958757,10/15 04:47 PM,F3N,107,115,0,0,222
958756,10/15 04:47 PM,F3XN,19,18,0,0,37
958755,10/15 04:47 PM,F3XN,0,0,0,0,0
958754,10/15 04:47 PM,F3XN,4,5,0,0,9
958753,10/15 04:47 PM,F3XN,31,3,0,0,34
958752,10/15 04:47 PM,F3N,29,126,0,1,156
958751,10/15 04:47 PM,F3XN,0,0,0,5,5
958750,10/15 04:46 PM,F3N,1442,279,0,7,1728
958749,10/15 04:46 PM,F3XA,206,91,50,9,356
958748,10/15 04:45 PM,F24N,0,0,33,0,33
958747,10/15 04:45 PM,F3N,0,0,0,0,0
958746,10/15 04:45 PM,F3N,284,248,0,2,534
958745,10/15 04:44 PM,F3N,389,875,0,67,1331
958744,10/15 04:44 PM,F3XN,0,3,0,6,9
958743,10/15 04:44 PM,F3XN,29,13,0,5,47
958742,10/15 04:44 PM,F3XN,1,13,1,1,16
958741,10/15 04:43 PM,F3N,101,73,0,1,175
958740,10/15 04:43 PM,F3N,679,364,0,2,1045
958739,10/15 04:43 PM,F24N,0,0,1,0,1
958738,10/15 04:43 PM,F3XN,1,2,0,0,3
958737,10/15 04:43 PM,F3N,1,11,0,1,13
958736,10/15 04:43 PM,F3XN,31,30,0,0,61
958735,10/15 04:43 PM,F3XA,0,3,0,0,3
958734,10/15 04:42 PM,F3XN,3,3,1,1,8
958733,10/15 04:41 PM,F3XN,88,90,0,1,179
958732,10/15 04:40 PM,F3A,36,36,0,15,87
958731,10/15 04:39 PM,F3XN,11,0,0,0,11
958730,10/15 04:39 PM,F3XN,0,1,0,0,1
958729,10/15 04:39 PM,F3N,863,105,0,0,968
958728,10/15 04:38 PM,F3N,200,116,0,7,323
958727,10/15 04:38 PM,F3N,47,67,0,1,115
958726,10/15 04:38 PM,F3N,162,113,0,10,285
958725,10/15 04:38 PM,F3XN,6,11,0,0,17
958724,10/15 04:37 PM,F3N,1,2,0,7,10
958723,10/15 04:37 PM,F3XN,3,8,10,9,30
958722,10/15 04:37 PM,F3XN,40,10,0,0,50
958721,10/15 04:37 PM,F3N,658,166,0,0,824
958720,10/15 04:37 PM,F3XN,0,4,0,0,4
958719,10/15 04:37 PM,F3XN,84,18,0,0,102
958718,10/15 04:37 PM,F1A,0,0,0,0,0
958717,10/15 04:37 PM,F3XA,0,1,0,7,8
958716,10/15 04:36 PM,F3N,1,1,0,1,3
958715,10/15 04:36 PM,F3XN,0,21,0,0,21
958714,10/15 04:36 PM,F3N,1794,428,0,2,2224
958713,10/15 04:36 PM,F3XA,0,2,0,4,6
958712,10/15 04:36 PM,F3XA,0,4,0,0,4
958711,10/15 04:35 PM,F3N,75,40,0,14,129
958710,10/15 04:35 PM,F3XN,0,10,0,0,10
958709,10/15 04:35 PM,F3XN,851,215,0,1,1067
958708,10/15 04:35 PM,F3XA,86,85,0,13,184
958707,10/15 04:35 PM,F3XN,224,36,0,0,260
958706,10/15 04:35 PM,F3N,132,65,0,0,197
958705,10/15 04:34 PM,F3XN,0,4,0,2,6
958704,10/15 04:34 PM,F7N,0,0,0,47,47
958703,10/15 04:34 PM,F3XN,4,2,0,0,6
958702,10/15 04:34 PM,F3XN,0,0,0,0,0
958701,10/15 04:33 PM,F3XA,0,1,0,2,3
958700,10/15 04:33 PM,F3N,360,98,0,0,458
958699,10/15 04:33 PM,F3XN,9,5,0,0,14
958698,10/15 04:33 PM,F3XN,1,3,0,0,4
958697,10/15 04:33 PM,F3XN,0,0,0,2,2
958696,10/15 04:32 PM,F3XN,1,3,0,0,4
958695,10/15 04:32 PM,F3XN,24,12,0,0,36
958694,10/15 04:32 PM,F3XN,4,1,0,2,7
958693,10/15 04:31 PM,F3XN,1,4,0,0,5
958692,10/15 04:31 PM,F3XN,7,13,0,0,20
958691,10/15 04:31 PM,F3XN,0,0,0,0,0
958690,10/15 04:31 PM,F3XN,2,3,0,0,5
958689,10/15 04:31 PM,F3XN,2,1,0,0,3
958688,10/15 04:30 PM,F3N,6,60,0,1,67
958687,10/15 04:30 PM,F3N,124,143,0,1,268
958686,10/15 04:29 PM,F3N,3,31,0,9,43
958685,10/15 04:29 PM,F3A,54,44,0,33,131
958684,10/15 04:29 PM,F3XN,12,0,0,0,12
958683,10/15 04:28 PM,F24N,0,0,6,0,6
958682,10/15 04:28 PM,F3N,4198,439,0,0,4637
958681,10/15 04:28 PM,F3N,260,160,0,0,420
958680,10/15 04:28 PM,F5N,0,0,3,0,3
958679,10/15 04:27 PM,F3N,66,70,0,12,148
958678,10/15 04:27 PM,F3XN,181,26,0,0,207
958677,10/15 04:26 PM,F24N,0,0,6,0,6
958676,10/15 04:26 PM,F3XN,68,5,0,0,73
958675,10/15 04:26 PM,F3XN,13,10,0,2,25
958674,10/15 04:25 PM,F3XN,76,10,0,0,86
958673,10/15 04:25 PM,F3XN,0,1,0,0,1
958672,10/15 04:25 PM,F24N,0,0,5,0,5
958671,10/15 04:24 PM,F3N,591,185,0,0,776
958670,10/15 04:24 PM,F3XN,0,1,0,2,3
958669,10/15 04:24 PM,F3N,57,52,0,5,114
958668,10/15 04:23 PM,F3N,950,302,0,0,1252
958667,10/15 04:23 PM,F24N,0,0,5,0,5
958666,10/15 04:23 PM,F3N,0,0,0,12,12
958665,10/15 04:22 PM,F3XN,0,3,0,6,9
958664,10/15 04:22 PM,F3XA,1,11,0,14,26
958663,10/15 04:22 PM,F3XN,6,0,0,0,6
958662,10/15 04:21 PM,F3N,146,68,0,0,214
958661,10/15 04:21 PM,F99,0,0,0,0,0
958660,10/15 04:21 PM,F3XN,18,18,0,0,36
958659,10/15 04:20 PM,F3N,642,230,0,0,872
958658,10/15 04:20 PM,F3XN,6,18,0,3,27
958657,10/15 04:20 PM,F3XN,2,1,0,0,3
958656,10/15 04:19 PM,F3XN,107,0,0,1,108
958655,10/15 04:19 PM,F3XN,0,0,0,0,0
958654,10/15 04:18 PM,F3XN,841,145,45,0,1031
958653,10/15 04:18 PM,F24N,0,0,5,0,5
958652,10/15 04:18 PM,F3XN,11,7,0,3,21
958651,10/15 04:18 PM,F3XN,0,0,0,0,0
958650,10/15 04:18 PM,F24N,0,0,7,0,7
958649,10/15 04:17 PM,F3XN,21,48,0,0,69
958648,10/15 04:16 PM,F3XN,31,5,0,1,37
958647,10/15 04:16 PM,F3XA,0,1,0,0,1
958646,10/15 04:16 PM,F3XA,4,3,0,16,23
958645,10/15 04:16 PM,F3XN,191,29,0,0,220
958644,10/15 04:16 PM,F99,0,0,0,0,0
958643,10/15 04:16 PM,F3XN,238,53,0,0,291
958642,10/15 04:16 PM,F3XN,1,8,0,0,9
958641,10/15 04:15 PM,F3N,0,3,0,0,3
958640,10/15 04:15 PM,F3N,51,24,0,2,77
958639,10/15 04:15 PM,F3XA,2,3,0,12,17
958638,10/15 04:14 PM,F3XN,89,1,0,89,179
958637,10/15 04:14 PM,F3XN,0,4,0,0,4
958636,10/15 04:14 PM,F3N,591,228,0,0,819
958635,10/15 04:13 PM,F3N,285,113,0,9,407
958634,10/15 04:13 PM,F3N,895,219,0,8,1122
958633,10/15 04:13 PM,F3N,23,25,0,1,49
958632,10/15 04:13 PM,F3XN,73,14,0,0,87
958631,10/15 04:13 PM,F3XN,0,0,0,26,26
958630,10/15 04:13 PM,F3N,32,45,0,9,86
958629,10/15 04:12 PM,F3XN,3,16,0,0,19
958628,10/15 04:12 PM,F3N,163,51,0,1,215
958627,10/15 04:12 PM,F3N,1109,178,0,3,1290
958626,10/15 04:12 PM,F3N,15,35,0,14,64
958625,10/15 04:12 PM,F3XN,87,6,0,0,93
958624,10/15 04:11 PM,F3N,129,187,0,0,316
958623,10/15 04:11 PM,F3XN,14,22,0,0,36
958622,10/15 04:10 PM,F3N,152,127,0,21,300
958621,10/15 04:10 PM,F3XN,0,0,0,0,0
958620,10/15 04:10 PM,F3XN,71,6,0,0,77
958619,10/15 04:10 PM,F3N,145,44,0,6,195
958618,10/15 04:10 PM,F3N,313,86,0,1,400
958617,10/15 04:09 PM,F3N,220,96,0,0,316
958616,10/15 04:09 PM,F3XN,1,11,0,14,26
958615,10/15 04:08 PM,F3XN,0,0,0,0,0
958614,10/15 04:08 PM,F3XN,8,11,0,1,20
958613,10/15 04:07 PM,F3A,73,54,0,0,127
958612,10/15 04:07 PM,F24A,0,0,1,0,1
958611,10/15 04:07 PM,F3N,185,125,0,11,321
958610,10/15 04:07 PM,F3N,27,14,0,4,45
958609,10/15 04:07 PM,F3XN,27,19,0,0,46
958608,10/15 04:06 PM,F3N,385,145,0,9,539
958607,10/15 04:06 PM,F3XN,86,62,49,6,203
958606,10/15 04:06 PM,F3N,103,124,0,0,227
958605,10/15 04:06 PM,F3N,585,197,0,1,783
958604,10/15 04:05 PM,F3XN,0,3,0,0,3
958603,10/15 04:05 PM,F3XN,1,0,0,0,1
958602,10/15 04:05 PM,F3N,289,107,0,0,396
958601,10/15 04:04 PM,F1A,0,0,0,0,0
958600,10/15 04:04 PM,F3N,0,2,0,10,12
958599,10/15 04:04 PM,F3XN,48,3,0,0,51
958598,10/15 04:04 PM,F3XN,0,1,0,0,1
958597,10/15 04:03 PM,F3N,0,8,0,2,10
958596,10/15 04:03 PM,F3XN,5,3,0,0,8
958595,10/15 04:03 PM,F3XN,1,0,0,0,1
958594,10/15 04:03 PM,F3XN,9,2,0,0,11
958593,10/15 04:03 PM,F3XN,11,6,0,0,17
958592,10/15 04:03 PM,F3N,28,46,0,0,74
958591,10/15 04:02 PM,F3XN,76,2,0,76,154
958590,10/15 04:02 PM,F3XN,0,0,0,0,0
958589,10/15 04:02 PM,F3XN,12,14,0,0,26
958588,10/15 04:01 PM,F3XN,2,2,0,0,4
958587,10/15 04:01 PM,F3XN,0,1,0,0,1
958586,10/15 04:01 PM,F3XN,14,2,0,0,16
958585,10/15 04:01 PM,F3XN,0,0,0,2,2
958584,10/15 04:01 PM,F3N,642,315,0,19,976
958583,10/15 04:01 PM,F3N,518,369,0,0,887
958582,10/15 04:01 PM,F3XA,10,0,0,0,10
958581,10/15 04:01 PM,F3A,34,39,0,1,74
958580,10/15 04:01 PM,F3N,138,175,0,1,314
958579,10/15 04:00 PM,F3N,27,75,0,0,102
958578,10/15 04:00 PM,F3N,14,37,0,0,51
958577,10/15 04:00 PM,F3XN,86,1,0,0,87
958576,10/15 04:00 PM,F3XN,6,5,0,0,11
958575,10/15 04:00 PM,F3A,72,63,0,0,135
958574,10/15 03:59 PM,F3XN,0,0,0,0,0
958573,10/15 03:59 PM,F3XN,185,167,0,0,352
958572,10/15 03:59 PM,F3N,2179,272,0,0,2451
958571,10/15 03:58 PM,F3XN,23,30,0,0,53
958570,10/15 03:58 PM,F3N,0,2,0,0,2
958569,10/15 03:58 PM,F3XN,10,11,0,0,21
958568,10/15 03:58 PM,F3XN,2,2,0,0,4
958567,10/15 03:58 PM,F3XN,10,16,0,0,26
958566,10/15 03:57 PM,F3XN,33,14,0,0,47
958565,10/15 03:57 PM,F3XN,5,6,0,0,11
958564,10/15 03:57 PM,F3XN,3,10,2,0,15
958563,10/15 03:56 PM,F3XN,0,0,0,3,3
958562,10/15 03:56 PM,F3XN,9,10,1,0,20
958561,10/15 03:56 PM,F3XN,0,1,0,0,1
958560,10/15 03:55 PM,F3A,12,20,0,3,35
958559,10/15 03:55 PM,F3XN,1,4,0,0,5
958558,10/15 03:55 PM,F3XN,13,6,3,0,22
958557,10/15 03:55 PM,F3N,28,8,0,0,36
958556,10/15 03:55 PM,F3XN,0,0,0,0,0
958555,10/15 03:54 PM,F3XN,0,2,0,1,3
958554,10/15 03:53 PM,F3A,57,16,0,3,76
958553,10/15 03:53 PM,F3XN,0,1,0,0,1
958552,10/15 03:53 PM,F3XN,3,6,0,0,9
958551,10/15 03:53 PM,F3XN,6,1,0,0,7
958550,10/15 03:53 PM,F3XN,76,6,0,0,82
958549,10/15 03:52 PM,F3XA,8,0,0,0,8
958548,10/15 03:52 PM,F3XN,84,9,0,0,93
958547,10/15 03:52 PM,F3XN,0,0,0,0,0
958546,10/15 03:52 PM,F3XN,3,0,0,0,3
958545,10/15 03:52 PM,F3XA,2,3,0,12,17
958544,10/15 03:52 PM,F3N,384,137,0,0,521
958543,10/15 03:51 PM,F3XN,0,2,0,0,2
958542,10/15 03:51 PM,F3XN,2,1,1,1,5
958541,10/15 03:51 PM,F2A,0,0,0,0,0
958540,10/15 03:51 PM,F3XN,3,8,0,5,16
958539,10/15 03:51 PM,F3XA,2,5,0,0,7
958538,10/15 03:50 PM,F5N,0,0,4,0,4
958537,10/15 03:50 PM,F3XN,0,1,0,0,1
958536,10/15 03:50 PM,F3XN,1,4,0,0,5
958535,10/15 03:50 PM,F3XN,1,4,0,0,5
958534,10/15 03:50 PM,F3N,0,11,0,0,11
958533,10/15 03:50 PM,F3XN,23,50,0,1,74
958532,10/15 03:50 PM,F3A,6,16,0,0,22
958531,10/15 03:49 PM,F3XN,10,4,2,0,16
958530,10/15 03:49 PM,F3XN,11,5,0,0,16
958529,10/15 03:49 PM,F3XN,1,16,0,0,17
958528,10/15 03:48 PM,F3T,6,12,0,1,19
958527,10/15 03:47 PM,F3N,226,69,0,2,297
958526,10/15 03:47 PM,F3N,5,20,0,0,25
958525,10/15 03:46 PM,F3N,452,211,0,110,773
958524,10/15 03:46 PM,F5N,1,0,30,0,31
958523,10/15 03:46 PM,F3N,780,118,0,4,902
958522,10/15 03:46 PM,F3XN,2,98,0,0,100
958521,10/15 03:46 PM,F3N,5,8,0,5,18
958520,10/15 03:46 PM,F3XN,0,0,0,4,4
958519,10/15 03:45 PM,F3XN,1,6,0,0,7
958518,10/15 03:45 PM,F3N,250,62,0,6,318
958517,10/15 03:45 PM,F3XN,6,116,0,0,122
958516,10/15 03:45 PM,F3XN,54,1,0,0,55
958515,10/15 03:41 PM,F5N,21,0,8,0,29
958514,10/15 03:44 PM,F3XN,2,10,0,0,12
958513,10/15 03:44 PM,F3XN,7,4,0,0,11
958512,10/15 03:44 PM,F3N,3,30,0,0,33
958511,10/15 03:44 PM,F3XN,0,7,0,0,7
958510,10/15 03:44 PM,F3N,1156,119,0,0,1275
958509,10/15 03:43 PM,F3XN,0,5,0,2,7
958508,10/15 03:43 PM,F3XN,27,26,0,0,53
958507,10/15 03:43 PM,F3XN,56,44,0,11,111
958506,10/15 03:43 PM,F3XN,0,0,0,0,0
958505,10/15 03:43 PM,F3N,12,10,0,0,22
958504,10/15 03:43 PM,F3XN,18,10,0,0,28
958503,10/15 03:43 PM,F24N,0,0,8,0,8
958502,10/15 03:42 PM,F3XN,0,5,0,0,5
958501,10/15 03:43 PM,F3N,158,81,0,3,242
958500,10/15 03:42 PM,F3XN,0,3,0,3,6
958499,10/15 03:42 PM,F3XA,39,4,0,0,43
958498,10/15 03:42 PM,F3XN,51,2,0,0,53
958497,10/15 03:42 PM,F3XN,1,0,0,0,1
958496,10/15 03:41 PM,F3XN,47,68,0,1,116
958495,10/15 03:41 PM,F3XN,0,0,0,0,0
958494,10/15 03:41 PM,F3N,0,0,0,1,1
958493,10/15 03:41 PM,F3N,217,117,0,13,347
958492,10/15 03:40 PM,F3XN,61,14,0,0,75
958491,10/15 03:40 PM,F3XN,9,5,0,0,14
958490,10/15 03:40 PM,F3N,279,255,0,18,552
958489,10/15 03:40 PM,F3XN,15,5,0,0,20
958488,10/15 03:40 PM,F3XN,143,81,0,0,224
958487,10/15 03:40 PM,F3XN,27,2,0,0,29
958486,10/15 03:39 PM,F24N,0,0,2,0,2
958485,10/15 03:39 PM,F3XN,44,77,0,0,121
958484,10/15 03:38 PM,F3N,66,78,0,27,171
958483,10/15 03:38 PM,F3XN,0,0,0,0,0
958482,10/15 03:38 PM,F3XN,0,12,0,2,14
958481,10/15 03:38 PM,F3XN,93,0,0,0,93
958480,10/15 03:38 PM,F3XA,46,8,0,0,54
958479,10/15 03:38 PM,F3XN,0,0,0,0,0
958478,10/15 03:38 PM,F3XN,62,2,0,47,111
958477,10/15 03:38 PM,F3N,9,6,0,0,15
958476,10/15 03:38 PM,F3XN,78,11,0,1,90
958475,10/15 03:37 PM,F3XN,10,15,0,0,25
958474,10/15 03:37 PM,F3XN,0,7,0,0,7
958473,10/15 03:37 PM,F3XN,18,0,0,0,18
958472,10/15 03:37 PM,F3XN,0,0,0,0,0
958471,10/15 03:37 PM,F3XN,96,69,0,0,165
958470,10/15 03:37 PM,F3XN,5,2,0,0,7
958469,10/15 03:37 PM,F3N,101,145,0,8,254
958468,10/15 03:36 PM,F3N,20,9,0,0,29
958467,10/15 03:36 PM,F3N,100,48,0,1,149
958466,10/15 03:36 PM,F3XN,44,14,0,0,58
958465,10/15 03:36 PM,F3N,312,52,0,1,365
958464,10/15 03:36 PM,F3XN,7,1,0,0,8
958463,10/15 03:35 PM,F3N,211,63,0,0,274
958462,10/15 03:35 PM,F3XN,0,1,0,0,1
958461,10/15 03:35 PM,F3N,2,98,0,0,100
958460,10/15 03:35 PM,F3A,103,50,0,17,170
958459,10/15 03:35 PM,F3XN,2,2,1,0,5
958458,10/15 03:34 PM,F3XN,3,0,1,0,4
958457,10/15 03:34 PM,F3XN,2,4,0,0,6
958456,10/15 03:34 PM,F3XN,0,0,0,0,0
958455,10/15 03:34 PM,F3N,26,21,0,0,47
958454,10/15 03:34 PM,F3XN,2,4,3,0,9
958453,10/15 03:33 PM,F3XN,0,0,0,0,0
958452,10/15 03:33 PM,F3XN,0,0,0,0,0
958451,10/15 03:33 PM,F3XN,0,5,0,0,5
958450,10/15 03:33 PM,F3XN,3,5,0,5,13
958449,10/15 03:32 PM,F1N,0,0,0,0,0
958448,10/15 03:32 PM,F3XA,8,2,0,0,10
958447,10/15 03:31 PM,F3N,54,86,0,4,144
958446,10/15 03:31 PM,F3XN,3,0,0,0,3
958445,10/15 03:31 PM,F3XN,0,0,0,0,0
958444,10/15 03:31 PM,F3N,164,81,0,3,248
958443,10/15 03:31 PM,F3XN,22,2,0,0,24
958442,10/15 03:31 PM,F3N,244,135,0,3,382
958441,10/15 03:31 PM,F3XN,16,7,0,0,23
958440,10/15 03:31 PM,F3N,47,16,0,3,66
958439,10/15 03:30 PM,F3XN,0,0,0,2,2
958438,10/15 03:30 PM,F3XN,0,3,0,0,3
958437,10/15 03:29 PM,F3N,98,53,0,2,153
958436,10/15 03:29 PM,F3XN,0,3,0,3,6
958435,10/15 03:29 PM,F3N,139,184,0,0,323
958434,10/15 03:29 PM,F3N,0,0,0,9,9
958433,10/15 03:29 PM,F3XN,55,3,0,0,58
958432,10/15 03:29 PM,F3XN,45,7,0,0,52
958431,10/15 03:29 PM,F3A,610,166,0,1,777
958430,10/15 03:29 PM,F3XN,4,22,0,0,26
958429,10/15 03:28 PM,F3XN,0,1,0,0,1
958428,10/15 03:28 PM,F3XN,0,0,0,0,0
958427,10/15 03:28 PM,F3N,240,89,0,0,329
958426,10/15 03:28 PM,F5N,0,0,12,0,12
958425,10/15 03:28 PM,F3XN,0,0,0,0,0
958424,10/15 03:28 PM,F3XN,0,0,0,13,13
958423,10/15 03:28 PM,F3XN,1,1,0,0,2
958422,10/15 03:27 PM,F3XN,0,1,0,0,1
958421,10/15 03:27 PM,F3N,145,87,0,2,234
958420,10/15 03:27 PM,F3XN,0,4,0,0,4
958419,10/15 03:27 PM,F3XN,0,1,0,0,1
958418,10/15 03:27 PM,F3XN,0,13,0,0,13
958417,10/15 03:26 PM,F3XA,0,9,0,0,9
958416,10/15 03:26 PM,F3XN,0,3,0,0,3
958415,10/15 03:26 PM,F3A,192,240,0,4,436
958414,10/15 03:26 PM,F3N,107,54,0,4,165
958413,10/15 03:26 PM,F3XN,0,5,0,0,5
958412,10/15 03:26 PM,F3XN,8,32,0,1,41
958411,10/15 03:26 PM,F3XN,0,1,0,0,1
958410,10/15 03:25 PM,F3XA,19,82,1,0,102
958409,10/15 03:24 PM,F3XN,1,21,0,1,23
958408,10/15 03:24 PM,F5N,0,0,0,0,0
958407,10/15 03:24 PM,F3XT,0,1,0,0,1
958406,10/15 03:24 PM,F3N,320,158,0,0,478
958405,10/15 03:23 PM,F3N,93,212,0,7,312
958404,10/15 03:22 PM,F3XN,70,1,0,0,71
958403,10/15 03:22 PM,F3XN,0,1,0,0,1
958402,10/15 03:22 PM,F3XN,0,0,0,0,0
958401,10/15 03:22 PM,F3XN,69,30,0,0,99
958400,10/15 03:22 PM,F3XN,71,36,0,0,107
958399,10/15 03:21 PM,F3A,808,118,0,1,927
958398,10/15 03:21 PM,F3XN,1,1,0,0,2
958397,10/15 03:21 PM,F3N,334,155,0,7,496
958396,10/15 03:21 PM,F3N,210,117,0,4,331
958395,10/15 03:21 PM,F3XN,0,0,0,0,0
958394,10/15 03:21 PM,F3XN,18,3,0,15,36
958393,10/15 03:20 PM,F3N,0,0,0,3,3
958392,10/15 03:20 PM,F3XN,5,18,0,0,23
958391,10/15 03:20 PM,F3XN,3,22,0,0,25
958390,10/15 03:20 PM,F3XN,1,2,0,0,3
958389,10/15 03:20 PM,F3XN,14,24,0,0,38
958388,10/15 03:19 PM,F3XA,38,36,0,0,74
958387,10/15 03:19 PM,F3XN,2,1,0,0,3
958386,10/15 03:19 PM,F3XN,0,0,0,0,0
958385,10/15 03:19 PM,F3XN,57,9,0,0,66
958384,10/15 03:18 PM,F3XN,0,5,0,0,5
958383,10/15 03:17 PM,F3XN,5,4,0,0,9
958382,10/15 03:16 PM,F3XA,11,1,0,0,12
958381,10/15 03:16 PM,F3XN,0,0,0,0,0
958380,10/15 03:16 PM,F3N,1131,350,0,0,1481
958379,10/15 03:15 PM,F3XN,1,31,0,0,32
958378,10/15 03:14 PM,F3XA,72,12,0,0,84
958377,10/15 03:14 PM,F3XN,2,36,0,0,38
958376,10/15 03:14 PM,F3XN,60,8,0,0,68
958375,10/15 03:14 PM,F3XN,6,6,0,0,12
958374,10/15 03:14 PM,F3N,125,184,0,0,309
958373,10/15 03:14 PM,F3N,65,72,0,14,151
958372,10/15 03:14 PM,F3N,753,216,0,0,969
958371,10/15 03:13 PM,F3XN,0,0,0,0,0
958370,10/15 03:13 PM,F24N,0,0,5,0,5
958369,10/15 03:13 PM,F3XN,1,1,0,0,2
958368,10/15 03:13 PM,F3XN,321,392,0,1,714
958367,10/15 03:12 PM,F3XN,44,11,0,0,55
958366,10/15 03:12 PM,F3N,156,57,0,0,213
958365,10/15 03:12 PM,F3XN,0,1,0,1,2
958364,10/15 03:12 PM,F3N,227,249,0,0,476
958363,10/15 03:12 PM,F3XN,132,78,0,1,211
958362,10/15 03:11 PM,F3XA,1,2,0,0,3
958361,10/15 03:11 PM,F3N,0,3,0,97,100
958360,10/15 03:11 PM,F3XN,3,0,0,0,3
958359,10/15 03:11 PM,F3N,410,138,0,11,559
958358,10/15 03:10 PM,F3XN,189,43,0,1,233
958357,10/15 03:10 PM,F3N,0,0,0,18,18
958356,10/15 03:09 PM,F3XN,2,3,0,0,5
958355,10/15 03:09 PM,F3XN,551,59,0,1,611
958354,10/15 03:09 PM,F3XN,12,3,0,0,15
958353,10/15 03:09 PM,F3N,559,407,0,11,977
958352,10/15 03:08 PM,F3XN,0,6,0,0,6
958351,10/15 03:08 PM,F3N,57,22,0,10,89
958350,10/15 03:08 PM,F3N,104,123,0,2,229
958349,10/15 03:08 PM,F3XN,1,3,0,5,9
958348,10/15 03:08 PM,F3N,55,239,0,10,304
958347,10/15 03:08 PM,F3N,0,0,0,1,1
958346,10/15 03:08 PM,F3XN,119,4,0,0,123
958345,10/15 03:08 PM,F3XN,85,9,0,0,94
958344,10/15 03:07 PM,F3N,384,114,0,1,499
958343,10/15 03:07 PM,F3XN,2,5,0,0,7
958342,10/15 03:06 PM,F3XN,2,4,11,0,17
958341,10/15 03:06 PM,F3XN,5,7,0,1,13
958340,10/15 03:06 PM,F3XN,18,0,0,0,18
958339,10/15 03:05 PM,F3XN,0,3,0,0,3
958338,10/15 03:05 PM,F3XN,0,4,0,0,4
958337,10/15 03:05 PM,F3XN,1300,402,20,18,1740
958336,10/15 03:05 PM,F3XN,176,3,0,0,179
958335,10/15 03:04 PM,F3N,418,248,0,0,666
958334,10/15 03:04 PM,F3XN,12,0,0,0,12
958333,10/15 03:04 PM,F3XN,0,0,0,0,0
958332,10/15 03:04 PM,F3XN,60,32,0,0,92
958331,10/15 03:04 PM,F3XN,16,7,0,0,23
958330,10/15 03:04 PM,F3N,46,14,0,11,71
958329,10/15 03:03 PM,F3XN,32,79,0,2,113
958328,10/15 03:03 PM,F3XN,0,0,0,0,0
958327,10/15 03:03 PM,F3N,299,169,0,8,476
958326,10/15 03:01 PM,F3N,217,147,0,31,395
958325,10/15 03:01 PM,F3XN,5,18,0,0,23
958324,10/15 03:00 PM,F3XN,10,13,0,0,23
958323,10/15 03:00 PM,F3N,178,171,0,1,350
958322,10/15 03:00 PM,F3XN,2,5,0,1,8
958321,10/15 02:59 PM,F3XN,1,13,0,0,14
958320,10/15 02:59 PM,F3N,0,4,0,43,47
958319,10/15 02:59 PM,F3N,6,19,0,0,25
958318,10/15 02:59 PM,F3XN,0,1,0,0,1
958317,10/15 02:58 PM,F3N,0,0,0,13,13
958316,10/15 02:57 PM,F3XN,1,5,0,0,6
958315,10/15 02:56 PM,F3N,3,68,0,2,73
958314,10/15 02:56 PM,F3XN,5,27,0,0,32
958313,10/15 02:56 PM,F3XN,0,2,0,3,5
958312,10/15 02:55 PM,F3XN,0,0,0,1,1
958311,10/15 02:55 PM,F3XN,1,17,0,0,18
958310,10/15 02:54 PM,F3XN,0,0,0,0,0
958309,10/15 02:54 PM,F3XN,0,0,0,0,0
958308,10/15 02:54 PM,F24N,0,0,1,0,1
958307,10/15 02:53 PM,F3N,3016,248,0,0,3264
958306,10/15 02:53 PM,F3XN,2,2,0,0,4
958305,10/15 02:52 PM,F3XN,0,0,0,0,0
958304,10/15 02:52 PM,F3XN,0,0,0,0,0
958303,10/15 02:51 PM,F3XN,16,52,0,1,69
958302,10/15 02:51 PM,F3N,10,1,0,0,11
958301,10/15 02:50 PM,F3XN,9,37,0,0,46
958300,10/15 02:50 PM,F3XN,532,285,0,0,817
958299,10/15 02:50 PM,F3XN,25,49,0,0,74
958298,10/15 02:50 PM,F3XN,91,75,0,0,166
958297,10/15 02:49 PM,F3N,100,215,0,5,320
958296,10/15 02:49 PM,F3XN,0,0,0,0,0
958295,10/15 02:49 PM,F3N,0,0,0,5,5
958294,10/15 02:49 PM,F3XN,2,0,0,0,2
958293,10/15 02:49 PM,F3XN,3,2,0,1,6
958292,10/15 02:48 PM,F3XN,0,0,0,0,0
958291,10/15 02:48 PM,F3XN,23,7,0,0,30
958290,10/15 02:48 PM,F3N,21,21,0,7,49
958289,10/15 02:47 PM,F3N,11,84,0,4,99
958288,10/15 02:47 PM,F3XN,371,13,0,0,384
958287,10/15 02:47 PM,F3XN,0,0,0,0,0
958286,10/15 02:47 PM,F3N,8,20,0,2,30
958285,10/15 02:47 PM,F3XN,0,0,0,0,0
958284,10/15 02:46 PM,F1N,0,0,0,0,0
958283,10/15 02:46 PM,F3XA,347,251,0,0,598
958282,10/15 02:45 PM,F3XN,0,0,0,0,0
958281,10/15 02:45 PM,F3N,9,88,0,0,97
958280,10/15 02:45 PM,F3XN,2,2,0,0,4
958279,10/15 02:44 PM,F3XA,208,142,32,9,391
958278,10/15 02:43 PM,F3XN,5,6,0,0,11
958277,10/15 02:43 PM,F5N,0,0,1,0,1
958276,10/15 02:43 PM,F24A,0,0,2,0,2
958275,10/15 02:43 PM,F5N,0,0,2,0,2
958274,10/15 02:42 PM,F5N,0,0,1,0,1
958273,10/15 02:41 PM,F3XN,2,4,0,0,6
958272,10/15 02:41 PM,F3XN,5,2,0,0,7
958271,10/15 02:41 PM,F99,0,0,0,0,0
958270,10/15 02:40 PM,F5N,0,0,1,0,1
958269,10/15 02:40 PM,F3XN,16,6,0,0,22
958268,10/15 02:40 PM,F3XN,9,22,0,0,31
958267,10/15 02:39 PM,F24N,0,0,5,0,5
958266,10/15 02:39 PM,F3XN,666,142,0,0,808
958265,10/15 02:38 PM,F24N,0,0,2,0,2
958264,10/15 02:38 PM,F3N,385,176,0,0,561
958263,10/15 02:38 PM,F3N,15,10,0,0,25
958262,10/15 02:37 PM,F3XN,0,0,13,2,15
958261,10/15 02:37 PM,F3N,484,304,0,1,789
958260,10/15 02:37 PM,F3N,244,65,0,7,316
958259,10/15 02:36 PM,F3N,298,92,0,1,391
958258,10/15 02:36 PM,F3XN,103,26,0,0,129
958257,10/15 02:35 PM,F3N,0,3,0,17,20
958256,10/15 02:35 PM,F3PN,6,15,0,9,30
958255,10/15 02:34 PM,F3XN,4,1,0,0,5
958254,10/15 02:34 PM,F3XN,4,9,0,0,13
958253,10/15 02:34 PM,F3N,424,503,0,0,927
958252,10/15 02:34 PM,F3XN,0,0,0,0,0
958251,10/15 02:33 PM,F3N,2045,208,0,0,2253
958250,10/15 02:33 PM,F3A,68,26,0,2,96
958249,10/15 02:33 PM,F3XN,1,1,0,0,2
958248,10/15 02:32 PM,F3XN,2,5,0,3,10
958247,10/15 02:32 PM,F3N,0,17,0,1,18
958246,10/15 02:32 PM,F3XA,22,29,0,1,52
958245,10/15 02:32 PM,F3XN,231,10,0,0,241
958244,10/15 02:32 PM,F3XN,2,0,0,0,2
958243,10/15 02:32 PM,F3XN,5,40,0,15,60
958242,10/15 02:30 PM,F3XA,677,45,0,1,723
958241,10/15 02:30 PM,F3N,5,7,0,0,12
958240,10/15 02:28 PM,F3N,224,198,0,1,423
958239,10/15 02:28 PM,F3N,113,60,0,0,173
958238,10/15 02:27 PM,F3XN,39,10,0,0,49
958237,10/15 02:26 PM,F3N,3,10,0,0,13
958236,10/15 02:26 PM,F3N,471,150,0,0,621
958235,10/15 02:26 PM,F3XN,0,0,0,0,0
958234,10/15 02:26 PM,F3T,0,0,0,1,1
958233,10/15 02:25 PM,F3XN,0,3,0,0,3
958232,10/15 02:25 PM,F3XN,233,56,0,0,289
958231,10/15 02:24 PM,F3N,0,0,0,0,0
958230,10/15 02:24 PM,F24N,0,0,2,0,2
958229,10/15 02:23 PM,F3N,292,77,0,0,369
958228,10/15 02:23 PM,F3N,29,73,0,0,102
958227,10/15 02:22 PM,F3XN,7,21,0,18,46
958226,10/15 02:22 PM,F3N,0,0,0,4,4
958225,10/15 02:21 PM,F3N,0,3,0,4,7
958224,10/15 02:21 PM,F3XN,2,10,0,2,14
958223,10/15 02:21 PM,F3XN,16,53,0,0,69
958222,10/15 02:21 PM,F3XN,32,3,0,3,38
958221,10/15 02:21 PM,F3XN,0,0,0,0,0
958220,10/15 02:20 PM,F3XN,1,1,0,0,2
958219,10/15 02:20 PM,F3XN,1,24,5,0,30
958218,10/15 02:20 PM,F3XN,3,0,0,0,3
958217,10/15 02:20 PM,F3XN,44,5,0,0,49
958216,10/15 02:18 PM,F3XN,0,8,0,0,8
958215,10/15 02:18 PM,F3N,0,0,0,0,0
958214,10/15 02:18 PM,F3XN,0,4,0,0,4
958213,10/15 02:18 PM,F3N,376,154,0,8,538
958212,10/15 02:17 PM,F3XN,742,48,0,0,790
958211,10/15 02:16 PM,F3XN,0,5,0,0,5
958210,10/15 02:16 PM,F3XN,0,6,0,0,6
958209,10/15 02:15 PM,F3XN,0,3,0,0,3
958208,10/15 02:15 PM,F3XN,4,7,0,0,11
958207,10/15 02:15 PM,F3XN,8,10,0,0,18
958206,10/15 02:15 PM,F3XA,0,5,0,0,5
958205,10/15 02:14 PM,F3XN,142,77,0,0,219
958204,10/15 02:14 PM,F3N,417,67,0,5,489
958203,10/15 02:12 PM,F3XN,200,9,0,0,209
958202,10/15 02:12 PM,F3XN,167,10,0,55,232
958201,10/15 02:12 PM,F3XN,0,0,0,0,0
958200,10/15 02:12 PM,F3XN,25,13,0,0,38
958199,10/15 02:12 PM,F3XA,29,18,0,0,47
958198,10/15 02:12 PM,F3N,48,20,0,1,69
958197,10/15 02:11 PM,F3N,104,66,0,0,170
958196,10/15 02:11 PM,F3XA,59,13,0,0,72
958195,10/15 02:11 PM,F3XN,0,1,0,0,1
958194,10/15 02:10 PM,F3XA,12,9,0,0,21
958193,10/15 02:10 PM,F3N,0,0,0,0,0
958192,10/15 02:09 PM,F3N,4,4,0,4,12
958191,10/15 02:09 PM,F3XN,53,3,0,0,56
958190,10/15 02:09 PM,F3XN,51,48,0,0,99
958189,10/15 02:09 PM,F3XN,89,34,0,0,123
958188,10/15 02:09 PM,F3XN,0,10,0,0,10
958187,10/15 02:09 PM,F3XN,0,0,0,0,0
958186,10/15 02:08 PM,F5N,0,0,2,0,2
958185,10/15 02:08 PM,F3XN,17,42,0,1,60
958184,10/15 02:07 PM,F3XN,3,1,0,0,4
958183,10/15 02:07 PM,F1N,0,0,0,0,0
958182,10/15 02:07 PM,F3XN,41,2,0,85,128
958181,10/15 02:06 PM,F3N,300,131,0,7,438
958180,10/15 02:06 PM,F3XN,0,1,0,0,1
958179,10/15 02:06 PM,F3XN,0,0,0,0,0
958178,10/15 02:06 PM,F3XN,6,8,0,0,14
958177,10/15 02:05 PM,F3XN,22,5,0,0,27
958176,10/15 02:04 PM,F3XN,0,0,0,0,0
958175,10/15 02:04 PM,F3XN,2,18,0,0,20
958174,10/15 02:04 PM,F3XN,7,10,0,3,20
958173,10/15 02:04 PM,F3XN,0,2,0,0,2
958172,10/15 02:04 PM,F3N,8,5,0,34,47
958171,10/15 02:04 PM,F3N,57,9,0,0,66
958170,10/15 02:03 PM,F3N,6,15,0,11,32
958169,10/15 02:03 PM,F24N,0,0,1,0,1
958168,10/15 02:03 PM,F3XN,1,0,0,0,1
958167,10/15 02:02 PM,F24N,0,0,1,0,1
958166,10/15 02:01 PM,F3N,114,192,0,0,306
958165,10/15 02:01 PM,F3N,588,153,0,29,770
958164,10/15 02:01 PM,F5N,0,0,2,0,2
958163,10/15 02:00 PM,F3XN,0,25,0,0,25
958162,10/15 02:00 PM,F3XN,0,4,0,0,4
958161,10/15 01:59 PM,F3XN,0,1,0,0,1
958160,10/15 01:59 PM,F3N,3530,205,0,0,3735
958159,10/15 01:58 PM,F3N,136,120,0,3,259
958158,10/15 01:58 PM,F3XN,3,1,0,0,4
958157,10/15 01:57 PM,F3N,9,33,0,0,42
958156,10/15 01:57 PM,F3XA,345,251,0,0,596
958155,10/15 01:57 PM,F3N,78,40,0,0,118
958154,10/15 01:57 PM,F3XN,51,3,0,0,54
958153,10/15 01:56 PM,F3N,106,107,0,0,213
958152,10/15 01:56 PM,F1N,0,0,0,0,0
958151,10/15 01:56 PM,F3XN,82,8,0,0,90
958150,10/15 01:56 PM,F3XN,147,106,0,0,253
958149,10/15 01:56 PM,F3N,12,21,0,0,33
958148,10/15 01:55 PM,F3XN,3,5,0,0,8
958147,10/15 01:55 PM,F3XA,0,16,0,0,16
958146,10/15 01:54 PM,F3XA,113,260,0,0,373
958145,10/15 01:54 PM,F3XN,0,0,0,0,0
958144,10/15 01:53 PM,F3N,461,178,0,2,641
958143,10/15 01:53 PM,F3N,200,115,0,0,315
958142,10/15 01:53 PM,F3XN,0,0,0,0,0
958141,10/15 01:53 PM,F3XN,6,0,0,2,8
958140,10/15 01:52 PM,F3XN,177,68,0,0,245
958139,10/15 01:51 PM,F3XN,0,6,0,0,6
958138,10/15 01:51 PM,F3XN,12,16,0,0,28
958137,10/15 01:50 PM,F3N,270,69,0,0,339
958136,10/15 01:50 PM,F3XA,303,466,0,0,769
958135,10/15 01:50 PM,F3N,7,30,0,10,47
958134,10/15 01:47 PM,F3XN,4,7,0,0,11
958133,10/15 01:47 PM,F3XN,12,9,0,0,21
958132,10/15 01:46 PM,F3A,415,179,0,1,595
958131,10/15 01:46 PM,F3A,27,13,0,2,42
958130,10/15 01:46 PM,F3N,371,206,0,1,578
958129,10/15 01:46 PM,F3XN,71,10,0,0,81
958128,10/15 01:45 PM,F3XN,0,0,0,0,0
958127,10/15 01:45 PM,F3XN,1,11,0,0,12
958126,10/15 01:45 PM,F3XN,0,0,0,0,0
958125,10/15 01:45 PM,F5N,0,0,1,0,1
958124,10/15 01:45 PM,F3XN,0,0,0,0,0
958123,10/15 01:44 PM,F3XN,7,4,0,0,11
958122,10/15 01:44 PM,F3XN,1,0,0,0,1
958121,10/15 01:43 PM,F3N,7,20,0,2,29
958120,10/15 01:42 PM,F3XN,0,1,0,0,1
958119,10/15 01:41 PM,F3XN,6,4,0,0,10
958118,10/15 01:41 PM,F3N,153,66,0,0,219
958117,10/15 01:40 PM,F3N,203,208,0,0,411
958116,10/15 01:39 PM,F3N,3,8,0,0,11
958115,10/15 01:38 PM,F3XA,36,8,0,0,44
958114,10/15 01:38 PM,F3N,0,1,0,8,9
958113,10/15 01:38 PM,F3N,0,0,0,16,16
958112,10/15 01:38 PM,F3XN,33,5,0,0,38
958111,10/15 01:37 PM,F3XN,2,3,0,0,5
958110,10/15 01:37 PM,F3XN,117,1,0,0,118
958109,10/15 01:36 PM,F3XN,6,5,0,0,11
958108,10/15 01:36 PM,F3N,763,254,0,0,1017
958107,10/15 01:36 PM,F3XN,5,4,0,0,9
958106,10/15 01:36 PM,F3XN,21,25,0,0,46
958105,10/15 01:35 PM,F3XN,1,1,0,0,2
958104,10/15 01:35 PM,F3XA,7,11,0,0,18
958103,10/15 01:35 PM,F3XN,0,0,0,0,0
958102,10/15 01:34 PM,F3XN,37,15,0,0,52
958101,10/15 01:34 PM,F5N,0,0,1,0,1
958100,10/15 01:34 PM,F3N,0,1,0,6,7
958099,10/15 01:34 PM,F3N,148,50,0,1,199
958098,10/15 01:34 PM,F3XN,23,0,0,0,23
958097,10/15 01:34 PM,F3A,282,146,0,1,429
958096,10/15 01:34 PM,F3N,0,0,0,5,5
958095,10/15 01:33 PM,F3XN,38,9,0,0,47
958094,10/15 01:33 PM,F3XN,9,5,1,1,16
958093,10/15 01:32 PM,F3XN,8,6,0,0,14
958092,10/15 01:32 PM,F3N,0,0,0,2,2
958091,10/15 01:32 PM,F3XN,491,10,0,0,501
958090,10/15 01:32 PM,F3XN,0,1,0,0,1
958089,10/15 01:32 PM,F3XN,19,32,0,0,51
958088,10/15 01:32 PM,F3XN,62,14,0,0,76
958087,10/15 01:31 PM,F3XN,1,2,0,0,3
958086,10/15 01:31 PM,F3XN,133,50,0,0,183
958085,10/15 01:31 PM,F3N,0,0,0,11,11
958084,10/15 01:29 PM,F3XN,8,6,0,0,14
958083,10/15 01:29 PM,F3N,0,3,0,0,3
958082,10/15 01:28 PM,F3N,32,30,0,0,62
958081,10/15 01:28 PM,F3XN,12,6,0,0,18
958080,10/15 01:27 PM,F24N,0,0,1,0,1
958079,10/15 01:26 PM,F3N,1289,204,0,0,1493
958078,10/15 01:26 PM,F3N,69,104,0,1,174
958077,10/15 01:25 PM,F3XN,5,15,17,2,39
958076,10/15 01:25 PM,F1A,0,0,0,0,0
958075,10/15 01:24 PM,F3N,212,56,0,3,271
958074,10/15 01:24 PM,F3XN,0,1,0,0,1
958073,10/15 01:24 PM,F3XN,0,1,0,0,1
958072,10/15 01:24 PM,F3N,258,74,0,2,334
958071,10/15 01:23 PM,F1N,0,0,0,0,0
958070,10/15 01:23 PM,F3N,467,188,0,0,655
958069,10/15 01:23 PM,F3N,411,192,0,0,603
958068,10/15 01:23 PM,F3XN,0,2,0,0,2
958067,10/15 01:23 PM,F3XN,7,1,0,0,8
958066,10/15 01:21 PM,F3XN,243,33,0,0,276
958065,10/15 01:20 PM,F3N,77,173,0,8,258
958064,10/15 01:19 PM,F3XN,1,7,0,0,8
958063,10/15 01:18 PM,F3XN,52,10,0,0,62
958062,10/15 01:18 PM,F3XN,0,6,0,1,7
958061,10/15 01:18 PM,F1A,0,0,0,0,0
958060,10/15 01:17 PM,F3XN,0,6,0,0,6
958059,10/15 01:17 PM,F3XN,5,1,5,3,14
958058,10/15 01:16 PM,F3XN,0,0,0,5,5
958057,10/15 01:16 PM,F3XN,3,28,0,0,31
958056,10/15 01:16 PM,F3N,0,0,0,0,0
958055,10/15 01:16 PM,F3XN,144,10,0,0,154
958054,10/15 01:16 PM,F3N,473,116,0,0,589
958053,10/15 01:15 PM,F3XN,8,11,4,0,23
958052,10/15 01:15 PM,F3N,142,111,0,0,253
958051,10/15 01:15 PM,F3N,35,7,0,1,43
958050,10/15 01:14 PM,F3XA,64,8,0,0,72
958049,10/15 01:14 PM,F3XN,118,1,0,0,119
958048,10/15 01:14 PM,F3XN,262,71,0,0,333
958047,10/15 01:14 PM,F3N,3,14,0,0,17
958046,10/15 01:14 PM,F3XN,10,1,0,0,11
958045,10/15 01:13 PM,F3A,241,102,0,1,344
958044,10/15 01:13 PM,F3XN,566,35,0,0,601
958043,10/15 01:12 PM,F3XN,12,2,0,0,14
958042,10/15 01:12 PM,F3N,21,15,0,0,36
958041,10/15 01:12 PM,F3A,10,3,0,0,13
958040,10/15 01:12 PM,F3N,0,9,0,1,10
958039,10/15 01:12 PM,F3XN,4,22,0,0,26
958038,10/15 01:12 PM,F3XN,39,5,0,0,44
958037,10/15 01:11 PM,F3XN,0,2,0,0,2
958036,10/15 01:11 PM,F3N,250,150,0,1,401
958035,10/15 01:11 PM,F3XN,218,48,0,1,267
958034,10/15 01:10 PM,F24N,0,0,5,0,5
958033,10/15 01:10 PM,F3A,392,273,0,66,731
958032,10/15 01:10 PM,F3XN,2,0,1,54,57
958031,10/15 01:10 PM,F3N,0,1,0,0,1
958030,10/15 01:09 PM,F5N,0,0,7,0,7
958029,10/15 01:08 PM,F3XN,10,0,0,0,10
958028,10/15 01:07 PM,F3XN,0,0,0,0,0
958027,10/15 01:07 PM,F1N,0,0,0,0,0
958026,10/15 01:07 PM,F3N,94,166,0,1,261
958025,10/15 01:06 PM,F3XN,37,14,0,0,51
958024,10/15 01:06 PM,F1N,0,0,0,0,0
958023,10/15 01:05 PM,F3XN,20,2,0,0,22
958022,10/15 01:05 PM,F3N,178,167,0,2,347
958021,10/15 01:05 PM,F3XN,37,16,0,0,53
958020,10/15 01:05 PM,F3XN,1,0,0,0,1
958019,10/15 01:05 PM,F3XA,594,61,0,11,666
958018,10/15 01:05 PM,F3N,0,0,0,3,3
958017,10/15 01:04 PM,F3XN,5,12,0,0,17
958016,10/15 01:04 PM,F3XN,7,3,4,0,14
958015,10/15 01:04 PM,F3N,255,125,0,0,380
958014,10/15 01:04 PM,F3XN,10,14,0,0,24
958013,10/15 01:04 PM,F3N,2,9,0,6,17
958012,10/15 01:04 PM,F5N,0,0,214,0,214
958011,10/15 01:03 PM,F3XN,0,0,0,0,0
958010,10/15 01:03 PM,F24A,0,0,3,0,3
958009,10/15 01:03 PM,F3XN,0,1,0,0,1
958008,10/15 01:03 PM,F6N,7,0,0,1,8
958007,10/15 01:03 PM,F3N,1,2,0,8,11
958006,10/15 01:02 PM,F3XN,0,1,0,0,1
958005,10/15 01:02 PM,F24N,0,0,1,0,1
958004,10/15 01:02 PM,F3N,7,11,0,0,18
958003,10/15 01:01 PM,F3XN,5,2,0,1,8
958002,10/15 01:00 PM,F3XN,3,9,0,0,12
958001,10/15 01:00 PM,F3XN,0,9,0,0,9
958000,10/15 12:59 PM,F3XN,6,8,0,7,21
957999,10/15 12:59 PM,F4N,0,8,0,0,8
957998,10/15 12:59 PM,F3XN,87,124,0,1,212
957997,10/15 12:59 PM,F3XN,4,10,0,0,14
957996,10/15 12:58 PM,F3XN,1,0,0,0,1
957995,10/15 12:58 PM,F3N,27,20,0,19,66
957994,10/15 12:57 PM,F3N,654,150,0,0,804
957993,10/15 12:57 PM,F3XN,0,4,0,0,4
957992,10/15 12:57 PM,F1A,0,0,0,0,0
957991,10/15 12:56 PM,F3XN,11,5,0,0,16
957990,10/15 12:56 PM,F3XA,15,6,0,0,21
957989,10/15 12:56 PM,F3XN,32,28,0,0,60
957988,10/15 12:56 PM,F3N,212,156,0,2,370
957987,10/15 12:55 PM,F3XN,0,0,0,0,0
957986,10/15 12:55 PM,F3XN,177,17,0,0,194
957985,10/15 12:55 PM,F3XN,94,37,0,0,131
957984,10/15 12:55 PM,F3XN,4,4,0,0,8
957983,10/15 12:55 PM,F3XT,0,0,0,0,0
957982,10/15 12:55 PM,F3XN,179,96,0,0,275
957981,10/15 12:55 PM,F3XN,12,20,0,0,32
957980,10/15 12:54 PM,F3XN,14,11,0,0,25
957979,10/15 12:53 PM,F3N,3,1,0,0,4
957978,10/15 12:53 PM,F3XN,0,0,0,0,0
957977,10/15 12:53 PM,F3XN,0,0,0,0,0
957976,10/15 12:53 PM,F3XN,1,1,0,0,2
957975,10/15 12:52 PM,F3XN,32,34,0,0,66
957974,10/15 12:52 PM,F3N,0,14,0,5,19
957973,10/15 12:51 PM,F3XN,13,17,0,1,31
957972,10/15 12:51 PM,F3XN,21,30,0,0,51
957971,10/15 12:51 PM,F3N,20,62,0,32,114
957970,10/15 12:51 PM,F3N,125,116,0,0,241
957969,10/15 12:50 PM,F3N,0,0,0,4,4
957968,10/15 12:50 PM,F3XN,34,39,0,0,73
957967,10/15 12:50 PM,F3XN,16,8,0,0,24
957966,10/15 12:50 PM,F3XN,5,5,0,0,10
957965,10/15 12:50 PM,F3N,10,2,0,0,12
957964,10/15 12:49 PM,F3XN,2,0,0,0,2
957963,10/15 12:49 PM,F3N,265,181,0,1,447
957962,10/15 12:48 PM,F3XN,8,14,0,0,22
957961,10/15 12:48 PM,F3XN,1,13,0,0,14
957960,10/15 12:48 PM,F3XN,0,8,0,0,8
957959,10/15 12:47 PM,F3XN,0,11,0,0,11
957958,10/15 12:47 PM,F3XN,0,1,0,0,1
957957,10/15 12:46 PM,F3XN,6882,77,1,2,6962
957956,10/15 12:46 PM,F3N,10,14,0,0,24
957955,10/15 12:46 PM,F6A,5,0,0,0,5
957954,10/15 12:46 PM,F3N,453,165,0,6,624
957953,10/15 12:46 PM,F3XN,141,37,0,0,178
957952,10/15 12:46 PM,F3N,4,28,0,0,32
957951,10/15 12:44 PM,F3N,317,116,0,0,433
957950,10/15 12:44 PM,F3XN,8,63,0,0,71
957949,10/15 12:44 PM,F3N,594,380,0,0,974
957948,10/15 12:44 PM,F3XN,0,0,0,0,0
957947,10/15 12:44 PM,F3XN,0,4,0,0,4
957946,10/15 12:44 PM,F3A,283,375,0,0,658
957945,10/15 12:43 PM,F3XN,247,42,0,1,290
957944,10/15 12:43 PM,F3N,0,2,0,0,2
957943,10/15 12:43 PM,F3XN,0,4,0,0,4
957942,10/15 12:43 PM,F3XN,40,12,0,0,52
957941,10/15 12:42 PM,F3N,131,84,0,0,215
957940,10/15 12:41 PM,F3XN,0,13,0,1,14
957939,10/15 12:41 PM,F3N,0,6,0,0,6
957938,10/15 12:40 PM,F3XN,0,4,0,0,4
957937,10/15 12:40 PM,F3XN,141,13,0,0,154
957936,10/15 12:39 PM,F3N,118,124,0,0,242
957935,10/15 12:38 PM,F3N,100,131,0,4,235
957934,10/15 12:38 PM,F3N,314,163,0,0,477
957933,10/15 12:38 PM,F3XN,0,1,0,0,1
957932,10/15 12:37 PM,F3XN,36,5,0,0,41
957931,10/15 12:37 PM,F3N,0,0,0,0,0
957930,10/15 12:37 PM,F3T,1,0,0,0,1
957929,10/15 12:37 PM,F3N,201,90,0,1,292
957928,10/15 12:37 PM,F3XN,40,14,0,0,54
957927,10/15 12:36 PM,F3XN,3,2,0,0,5
957926,10/15 12:36 PM,F3XN,25,11,0,0,36
957925,10/15 12:36 PM,F3XN,37,13,0,0,50
957924,10/15 12:36 PM,F3XN,0,2,0,0,2
957923,10/15 12:36 PM,F3XN,261,33,0,0,294
957922,10/15 12:35 PM,F3N,0,0,0,0,0
957921,10/15 12:35 PM,F3XN,16,3,0,0,19
957920,10/15 12:34 PM,F3XN,0,4,0,0,4
957919,10/15 12:34 PM,F3XN,1409,46,0,0,1455
957918,10/15 12:33 PM,F3XN,0,0,0,0,0
957917,10/15 12:33 PM,F3XN,3,2,0,3,8
957916,10/15 12:33 PM,F3XN,0,0,0,0,0
957915,10/15 12:31 PM,F3XN,6,1,0,0,7
957914,10/15 12:31 PM,F3XN,22,9,0,0,31
957913,10/15 12:31 PM,F3N,3,12,0,0,15
957912,10/15 12:30 PM,F3XN,0,0,0,0,0
957911,10/15 12:30 PM,F3XN,178,175,14,0,367
957910,10/15 12:29 PM,F5N,0,0,2,1,3
957909,10/15 12:29 PM,F3XN,23,34,0,0,57
957908,10/15 12:29 PM,F3XN,0,6,0,0,6
957907,10/15 12:26 PM,F3XN,0,4,0,0,4
957906,10/15 12:26 PM,F5N,0,0,1,0,1
957905,10/15 12:26 PM,F5N,0,0,1,0,1
957904,10/15 12:24 PM,F3XN,0,0,0,0,0
957903,10/15 12:24 PM,F3N,3,137,0,15,155
957902,10/15 12:23 PM,F3XN,24,55,0,0,79
957901,10/15 12:23 PM,F3N,259,205,0,3,467
957900,10/15 12:23 PM,F3XN,0,0,1,0,1
957899,10/15 12:22 PM,F3XN,0,0,0,0,0
957898,10/15 12:21 PM,F3XN,2,1,0,0,3
957897,10/15 12:21 PM,F3XN,21,20,0,0,41
957896,10/15 12:20 PM,F3N,237,152,0,1,390
957895,10/15 12:20 PM,F3XN,0,7,0,0,7
957894,10/15 12:19 PM,F3XN,4,2,0,0,6
957893,10/15 12:19 PM,F3XN,6,5,0,0,11
957892,10/15 12:18 PM,F3XN,21,24,0,0,45
957891,10/15 12:17 PM,F3XN,0,0,0,0,0
957890,10/15 12:17 PM,F2N,0,0,0,0,0
957889,10/15 12:17 PM,F24N,0,0,1,0,1
957888,10/15 12:16 PM,F3XN,17,3,0,0,20
957887,10/15 12:15 PM,F3N,648,259,0,0,907
957886,10/15 12:15 PM,F3XN,30,19,0,0,49
957885,10/15 12:15 PM,F1N,0,0,0,0,0
957884,10/15 12:15 PM,F3N,5,99,0,0,104
957883,10/15 12:15 PM,F99,0,0,0,0,0
957882,10/15 12:14 PM,F3N,0,3,0,1,4
957881,10/15 12:13 PM,F5N,1,0,5,0,6
957880,10/15 12:12 PM,F3XN,246,23,0,0,269
957879,10/15 12:12 PM,F3XN,0,1,0,0,1
957878,10/15 12:12 PM,F3XN,21,25,0,18,64
957877,10/15 12:12 PM,F3XN,25,5,0,0,30
957876,10/15 12:11 PM,F3N,1222,146,0,1,1369
957875,10/15 12:11 PM,F3XN,45,26,0,0,71
957874,10/15 12:11 PM,F3N,96,49,0,0,145
957873,10/15 12:10 PM,F3N,0,0,0,0,0
957872,10/15 12:10 PM,F24N,0,0,2,0,2
957871,10/15 12:09 PM,F3XN,0,1,0,0,1
957870,10/15 12:09 PM,F3XN,1151,248,0,0,1399
957869,10/15 12:08 PM,F3XN,0,0,0,0,0
957868,10/15 12:07 PM,F3XN,183,10,0,0,193
957867,10/15 12:05 PM,F3N,0,0,0,0,0
957866,10/15 12:05 PM,F3XN,0,0,0,0,0
957865,10/15 12:05 PM,F3XN,24,28,0,0,52
957864,10/15 12:04 PM,F3XN,0,6,0,0,6
957863,10/15 12:04 PM,F3XN,4,0,0,0,4
957862,10/15 12:04 PM,F3N,129,77,0,2,208
957861,10/15 12:03 PM,F3XA,176,16,0,0,192
957860,10/15 12:04 PM,F3XN,17,2,0,45,64
957859,10/15 12:03 PM,F3XN,5,0,0,0,5
957858,10/15 12:03 PM,F3N,0,0,0,5,5
957857,10/15 12:03 PM,F3XN,3,49,0,0,52
957856,10/15 12:02 PM,F3XN,45,14,0,0,59
957855,10/15 12:02 PM,F3N,158,149,0,0,307
957854,10/15 12:02 PM,F3XN,10,2,0,0,12
957853,10/15 12:01 PM,F3XN,14,12,0,0,26
957852,10/15 12:01 PM,F99,0,0,0,0,0
957851,10/15 12:00 PM,F3N,1,3,0,0,4
957850,10/15 12:00 PM,F3XN,0,5,6,0,11
957849,10/15 11:59 AM,F3XN,0,1,0,0,1
957848,10/15 11:59 AM,F3N,207,122,0,0,329
957847,10/15 11:58 AM,F3XN,34,16,0,0,50
957846,10/15 11:58 AM,F3N,518,118,0,0,636
957845,10/15 11:58 AM,F3N,59,42,0,6,107
957844,10/15 11:57 AM,F99,0,0,0,0,0
957843,10/15 11:56 AM,F3XN,573,99,0,0,672
957842,10/15 11:56 AM,F3XN,23,5,0,40,68
957841,10/15 11:56 AM,F3N,265,189,0,33,487
957840,10/15 11:55 AM,F3N,879,234,0,3,1116
957839,10/15 11:55 AM,F3XN,3,5,0,257,265
957838,10/15 11:55 AM,F3XA,3,1,0,2,6
957837,10/15 11:54 AM,F3XN,5,0,0,0,5
957836,10/15 11:54 AM,F3N,604,166,0,1,771
957835,10/15 11:54 AM,F3XN,1,0,0,0,1
957834,10/15 11:54 AM,F3XN,0,1,0,0,1
957833,10/15 11:53 AM,F3XN,165,37,0,0,202
957832,10/15 11:52 AM,F3XA,602,231,0,0,833
957831,10/15 11:52 AM,F3XN,10,5,0,0,15
957830,10/15 11:50 AM,F3XN,954,35,0,1,990
957829,10/15 11:50 AM,F3XA,1228,247,0,0,1475
957828,10/15 11:49 AM,F3XN,3,0,0,43,46
957827,10/15 11:49 AM,F3XA,4,11,0,0,15
957826,10/15 11:48 AM,F3XN,0,2,0,0,2
957825,10/15 11:48 AM,F3A,1,7,0,0,8
957824,10/15 11:48 AM,F3N,2491,219,0,0,2710
957823,10/15 11:48 AM,F3N,168,141,0,0,309
957822,10/15 11:47 AM,F3N,352,168,0,0,520
957821,10/15 11:47 AM,F3XA,31,13,0,1,45
957820,10/15 11:46 AM,F3XN,2,1,0,0,3
957819,10/15 11:46 AM,F3XN,21,11,0,0,32
957818,10/15 11:46 AM,F3N,8,17,0,2,27
957817,10/15 11:46 AM,F3N,79,113,0,0,192
957816,10/15 11:46 AM,F3PN,0,3,0,0,3
957815,10/15 11:45 AM,F3XN,4,1,0,0,5
957814,10/15 11:45 AM,F3XN,3,36,0,0,39
957813,10/15 11:44 AM,F3N,1,2,0,92,95
957812,10/15 11:43 AM,F3XN,3,1,0,0,4
957811,10/15 11:43 AM,F3N,85,49,0,2,136
957810,10/15 11:43 AM,F24N,0,0,5,0,5
957809,10/15 11:42 AM,F3XN,0,0,0,4,4
957808,10/15 11:41 AM,F3N,285,261,0,7,553
957807,10/15 11:41 AM,F3N,139,15,0,0,154
957806,10/15 11:41 AM,F3XN,2,0,0,17,19
957805,10/15 11:41 AM,F3N,19,5,0,0,24
957804,10/15 11:41 AM,F5N,0,0,4,0,4
957803,10/15 11:40 AM,F3N,319,196,0,0,515
957802,10/15 11:40 AM,F3N,15,6,0,12,33
957801,10/15 11:38 AM,F3N,0,0,0,0,0
957800,10/15 11:38 AM,F3XA,129,121,0,0,250
957799,10/15 11:38 AM,F3XN,0,0,0,0,0
957798,10/15 11:38 AM,F3XN,42,13,16,0,71
957797,10/15 11:37 AM,F3XN,6,7,0,0,13
957796,10/15 11:37 AM,F3A,83,232,0,8,323
957795,10/15 11:37 AM,F3XN,930,55,0,0,985
957794,10/15 11:36 AM,F3XA,20,27,0,1,48
957793,10/15 11:36 AM,F3XN,2,4,0,0,6
957792,10/15 11:36 AM,F24N,0,0,22,0,22
957791,10/15 11:35 AM,F3PN,13,34,0,1,48
957790,10/15 11:35 AM,F3XN,0,8,0,1,9
957789,10/15 11:34 AM,F3XN,22,5,0,0,27
957788,10/15 11:34 AM,F3PA,9,31,0,0,40
957787,10/15 11:33 AM,F3XN,0,12,0,0,12
957786,10/15 11:32 AM,F3XN,9,7,0,0,16
957785,10/15 11:32 AM,F3A,104,451,0,0,555
957784,10/15 11:32 AM,F3XN,0,8,0,0,8
957783,10/15 11:31 AM,F3XN,1,3,0,0,4
957782,10/15 11:31 AM,F3N,35,31,0,2,68
957781,10/15 11:31 AM,F99,0,0,0,0,0
957779,10/15 11:31 AM,F3N,0,2,0,0,2
957778,10/15 11:30 AM,F3XN,0,0,0,0,0
957777,10/15 11:30 AM,F3XN,1,2,0,0,3
957776,10/15 11:29 AM,F3XN,1,8,0,0,9
957775,10/15 11:27 AM,F3XN,591,84,0,0,675
957774,10/15 11:27 AM,F3N,0,0,0,4,4
957773,10/15 11:27 AM,F3XN,0,0,0,0,0
957772,10/15 11:27 AM,F3N,37,75,0,0,112
957771,10/15 11:27 AM,F3XN,12,8,0,1,21
957770,10/15 11:26 AM,F3A,161,391,0,0,552
957769,10/15 11:26 AM,F3XN,2,16,0,0,18
957768,10/15 11:25 AM,F3XN,7,0,0,0,7
957767,10/15 11:22 AM,F3XN,5,6,0,0,11
957766,10/15 11:20 AM,F3N,159,90,0,8,257
957765,10/15 11:19 AM,F3XA,4,10,0,0,14
957764,10/15 11:19 AM,F3XN,45,5,0,0,50
957763,10/15 11:19 AM,F3XN,38,20,0,0,58
957762,10/15 11:19 AM,F3XA,26,49,43,13,131
957761,10/15 11:19 AM,F3XN,0,0,0,0,0
957760,10/15 11:17 AM,F3XN,109,38,0,0,147
957759,10/15 11:16 AM,F3XN,8,9,2,3,22
957758,10/15 11:16 AM,F3XN,5,0,0,0,5
957757,10/15 11:16 AM,F3XN,1,10,0,0,11
957756,10/15 11:15 AM,F3N,232,116,0,0,348
957755,10/15 11:15 AM,F3XN,0,0,0,0,0
957754,10/15 11:14 AM,F3XN,3070,159,0,0,3229
957753,10/15 11:14 AM,F3XN,5,6,0,0,11
957752,10/15 11:13 AM,F3XN,0,1,0,0,1
957751,10/15 11:13 AM,F3XN,0,0,0,0,0
957750,10/15 11:12 AM,F3XN,24,31,0,1,56
957749,10/15 11:12 AM,F3XN,6,9,5,0,20
957748,10/15 11:12 AM,F3XA,2,14,0,2,18
957747,10/15 11:11 AM,F1MN,0,0,0,0,0
957746,10/15 11:11 AM,F3XN,187,43,0,1,231
957745,10/15 11:10 AM,F3N,0,1,0,0,1
957744,10/15 11:10 AM,F3XN,0,2,0,0,2
957743,10/15 11:10 AM,F3N,0,5,0,8,13
957742,10/15 11:09 AM,F3N,252,196,0,0,448
957741,10/15 11:09 AM,F3N,211,90,0,0,301
957740,10/15 11:08 AM,F3XN,0,15,0,0,15
957739,10/15 11:08 AM,F3XN,3,4,5,0,12
957738,10/15 11:07 AM,F3XN,8,11,0,0,19
957737,10/15 11:07 AM,F3XN,261,9,0,1,271
957736,10/15 11:07 AM,F3N,68,66,0,2,136
957735,10/15 11:07 AM,F3XN,49,29,0,0,78
957734,10/15 11:07 AM,F3XN,8,11,0,0,19
957733,10/15 11:07 AM,F3XN,121,3,0,1,125
957732,10/15 11:07 AM,F3XA,2,1,0,2,5
957731,10/15 11:06 AM,F3N,19,7,0,6,32
957730,10/15 11:06 AM,F3XN,0,0,0,0,0
957729,10/15 11:06 AM,F3N,0,1,0,0,1
957728,10/15 11:06 AM,F3N,0,0,0,4,4
957727,10/15 11:05 AM,F3XN,259,3,0,0,262
957726,10/15 11:05 AM,F3XN,0,0,0,0,0
957725,10/15 11:04 AM,F3N,51,56,0,1,108
957724,10/15 11:04 AM,F3N,37,156,0,13,206
957723,10/15 11:04 AM,F3XN,0,0,0,0,0
957722,10/15 11:04 AM,F3XN,0,0,0,0,0
957721,10/15 11:03 AM,F3N,125,67,0,5,197
957720,10/15 11:03 AM,F3XN,17,24,0,0,41
957719,10/15 11:03 AM,F3XN,1,0,0,13,14
957718,10/15 11:03 AM,F3XN,0,0,0,0,0
957717,10/15 11:02 AM,F3XN,2,1,0,0,3
957716,10/15 11:02 AM,F3XA,6,14,0,2,22
957715,10/15 11:02 AM,F3XN,0,25,0,3,28
957714,10/15 11:02 AM,F3N,22,16,0,0,38
957713,10/15 11:01 AM,F3N,8,12,0,2,22
957712,10/15 11:01 AM,F3XN,181,19,0,1,201
957711,10/15 11:00 AM,F3N,8,4,0,0,12
957710,10/15 11:00 AM,F3XN,0,0,0,0,0
957709,10/15 10:59 AM,F3XN,0,3,0,1,4
957708,10/15 10:59 AM,F3N,964,176,0,1,1141
957707,10/15 10:59 AM,F3N,0,4,0,0,4
957706,10/15 10:59 AM,F3XA,4,2,0,1,7
957705,10/15 10:58 AM,F3N,542,186,0,2,730
957704,10/15 10:58 AM,F3XN,0,0,0,0,0
957703,10/15 10:57 AM,F3XN,0,2,0,5,7
957702,10/15 10:57 AM,F3A,110,46,0,0,156
957701,10/15 10:56 AM,F3XN,4,5,0,0,9
957700,10/15 10:56 AM,F3XN,15,107,0,0,122
957699,10/15 10:56 AM,F3N,127,191,0,0,318
957698,10/15 10:56 AM,F3N,261,117,0,0,378
957697,10/15 10:56 AM,F3XN,9,2,0,0,11
957696,10/15 10:55 AM,F5N,0,0,14,1,15
957695,10/15 10:54 AM,F3N,14,6,0,0,20
957694,10/15 10:53 AM,F3XN,13,4,0,0,17
957693,10/15 10:53 AM,F3N,314,216,0,4,534
957692,10/15 10:52 AM,F3XN,0,6,0,0,6
957691,10/15 10:52 AM,F3XN,1,0,0,0,1
957690,10/15 10:51 AM,F3XN,13,52,0,0,65
957689,10/15 10:51 AM,F3A,209,75,0,3,287
957688,10/15 10:51 AM,F3A,139,201,0,12,352
957687,10/15 10:50 AM,F5N,0,0,449,0,449
957686,10/15 10:50 AM,F3A,22,26,0,0,48
957685,10/15 10:50 AM,F3N,0,0,0,2,2
957684,10/15 10:49 AM,F3A,196,187,0,5,388
957683,10/15 10:49 AM,F3N,2,5,0,63,70
957682,10/15 10:48 AM,F3XN,3,10,0,0,13
957681,10/15 10:48 AM,F24N,0,0,4,0,4
957680,10/15 10:47 AM,F3XN,0,0,0,0,0
957679,10/15 10:47 AM,F3A,157,186,0,9,352
957678,10/15 10:47 AM,F3XN,22,6,0,0,28
957677,10/15 10:47 AM,F3XN,0,4,0,0,4
957676,10/15 10:47 AM,F3XN,0,1,0,2,3
957675,10/15 10:46 AM,F3XN,0,0,0,0,0
957674,10/15 10:46 AM,F3XN,0,0,0,0,0
957673,10/15 10:46 AM,F3XN,0,0,0,21,21
957672,10/15 10:46 AM,F3XN,1,0,0,0,1
957671,10/15 10:45 AM,F3N,2353,297,0,0,2650
957670,10/15 10:45 AM,F3XT,0,3,0,0,3
957669,10/15 10:44 AM,F3N,286,256,0,0,542
957668,10/15 10:44 AM,F3XN,105,34,0,0,139
957667,10/15 10:43 AM,F3XN,0,0,0,0,0
957666,10/15 10:43 AM,F3XA,9,14,0,7,30
957665,10/15 10:43 AM,F3XN,86,11,0,0,97
957664,10/15 10:42 AM,F5N,0,0,4,0,4
957663,10/15 10:42 AM,F3XN,71,19,0,0,90
957662,10/15 10:41 AM,F3XN,41,12,0,0,53
957661,10/15 10:41 AM,F3XN,3,2,0,1,6
957660,10/15 10:40 AM,F3XN,421,3,0,1,425
957659,10/15 10:40 AM,F3XN,16,177,0,0,193
957658,10/15 10:40 AM,F3N,303,167,0,4,474
957657,10/15 10:39 AM,F3XN,83,3,0,0,86
957656,10/15 10:39 AM,F3XN,8,7,0,0,15
957655,10/15 10:38 AM,F3XN,162,15,0,0,177
957654,10/15 10:36 AM,F3XN,16,0,0,0,16
957653,10/15 10:36 AM,F3XN,1,3,0,0,4
957652,10/15 10:35 AM,F3XN,1,1,0,0,2
957651,10/15 10:34 AM,F3XN,0,4,0,0,4
957650,10/15 10:34 AM,F3XN,13,0,0,0,13
957649,10/15 10:33 AM,F3N,470,47,0,0,517
957648,10/15 10:33 AM,F3N,0,16,0,8,24
957647,10/15 10:32 AM,F3XN,0,0,0,0,0
957646,10/15 10:31 AM,F3A,5,17,0,8,30
957645,10/15 10:31 AM,F3XN,9,14,0,7,30
957644,10/15 10:31 AM,F3XN,47,5,0,0,52
957643,10/15 10:31 AM,F3N,0,0,0,51,51
957642,10/15 10:30 AM,F3XN,27,13,0,0,40
957641,10/15 10:30 AM,F3XN,0,0,0,0,0
957640,10/15 10:29 AM,F3XN,4,8,0,0,12
957639,10/15 10:28 AM,F3N,1,17,0,2,20
957638,10/15 10:27 AM,F3N,1,5,0,1,7
957637,10/15 10:26 AM,F3XN,13,3,0,0,16
957636,10/15 10:26 AM,F3XN,15,6,0,0,21
957635,10/15 10:26 AM,F3XN,0,0,0,0,0
957634,10/15 10:26 AM,F3XN,23,6,0,0,29
957633,10/15 10:25 AM,F3XN,32,43,0,0,75
957632,10/15 10:25 AM,F3XN,7,3,0,0,10
957631,10/15 10:25 AM,F3XN,5,42,0,0,47
957630,10/15 10:24 AM,F3XN,48,7,0,0,55
957629,10/15 10:24 AM,F3XN,192,5,0,0,197
957628,10/15 10:24 AM,F3XN,50,15,0,0,65
957627,10/15 10:23 AM,F3N,0,12,0,0,12
957626,10/15 10:23 AM,F3N,154,51,0,0,205
957625,10/15 10:23 AM,F3N,3,10,0,0,13
957624,10/15 10:22 AM,F3XN,27,27,9,0,63
957623,10/15 10:22 AM,F3XN,1,1,0,0,2
957622,10/15 10:22 AM,F24N,0,0,2,0,2
957621,10/15 10:22 AM,F3XN,11,1,0,0,12
957620,10/15 10:21 AM,F3N,109,155,0,0,264
957619,10/15 10:21 AM,F3XN,105,69,0,1,175
957618,10/15 10:20 AM,F3XN,0,3,0,0,3
957617,10/15 10:20 AM,F24N,0,0,2,0,2
957616,10/15 10:20 AM,F3XN,0,0,0,0,0
957615,10/15 10:20 AM,F3PN,3,5,0,0,8
957614,10/15 10:19 AM,F3A,198,31,0,0,229
957613,10/15 10:19 AM,F3XN,0,5,0,0,5
957612,10/15 10:19 AM,F3XN,5,15,0,5,25
957611,10/15 10:18 AM,F3N,1,20,0,3,24
957610,10/15 10:17 AM,F3XN,1,53,0,0,54
957609,10/15 10:17 AM,F3XN,0,0,0,10,10
957608,10/15 10:17 AM,F3XN,382,15,0,1,398
957607,10/15 10:15 AM,F3XN,56,1,0,0,57
957606,10/15 10:14 AM,F3XN,40,7,0,0,47
957605,10/15 10:13 AM,F3XN,0,0,0,0,0
957604,10/15 10:12 AM,F3XN,0,0,0,0,0
957603,10/15 10:12 AM,F3XN,5,2,4,0,11
957602,10/15 10:11 AM,F99,0,0,0,0,0
957601,10/15 10:11 AM,F3XN,0,0,0,0,0
957600,10/15 10:10 AM,F3XA,4,4,0,247,255
957599,10/15 10:09 AM,F3XA,5,8,0,0,13
957598,10/15 10:08 AM,F5N,0,0,2,0,2
957597,10/15 10:08 AM,F3XN,33,6,0,0,39
957596,10/15 10:08 AM,F3XN,1,1,1,0,3
957595,10/15 10:08 AM,F3XN,0,0,0,0,0
957594,10/15 10:08 AM,F3XN,338,37,0,0,375
957593,10/15 10:07 AM,F3XN,0,0,0,0,0
957592,10/15 10:07 AM,F3XN,17,13,0,0,30
957591,10/15 10:07 AM,F3XN,0,0,0,0,0
957590,10/15 10:06 AM,F3N,0,0,0,34,34
957589,10/15 10:05 AM,F3XN,0,3,0,0,3
957588,10/15 10:05 AM,F3XN,0,1,0,0,1
957587,10/15 10:05 AM,F3XN,40,15,0,0,55
957586,10/15 10:04 AM,F3N,3,25,0,0,28
957585,10/15 10:04 AM,F3XN,9,0,0,38,47
957584,10/15 10:04 AM,F3XN,0,0,0,0,0
957583,10/15 10:03 AM,F3XN,3,2,0,2,7
957582,10/15 10:03 AM,F3XN,15,0,0,0,15
957581,10/15 10:01 AM,F3XN,232,6,0,1,239
957580,10/15 10:01 AM,F3XN,7,0,0,0,7
957579,10/15 10:00 AM,F24N,0,0,2,0,2
957578,10/15 10:00 AM,F3N,19,39,0,23,81
957577,10/15 10:00 AM,F3XN,109,119,0,0,228
957576,10/15 10:00 AM,F3XN,0,0,0,0,0
957575,10/15 09:59 AM,F3XN,37,29,0,0,66
957574,10/15 09:54 AM,F3XN,13,7,0,0,20
957573,10/15 09:54 AM,F3N,0,9,0,0,9
957572,10/15 09:53 AM,F3XN,2,0,0,0,2
957571,10/15 09:53 AM,F3XN,49,40,0,0,89
957570,10/15 09:50 AM,F5N,0,0,2,0,2
957569,10/15 09:50 AM,F3XN,2,5,0,0,7
957568,10/15 09:48 AM,F3XN,16,8,0,0,24
957567,10/15 09:48 AM,F3N,354,256,0,27,637
957566,10/15 09:47 AM,F3XN,66,24,0,0,90
957565,10/15 09:46 AM,F3N,0,0,0,24,24
957564,10/15 09:45 AM,F3XN,0,0,0,0,0
957563,10/15 09:45 AM,F3T,0,6,0,3,9
957562,10/15 09:45 AM,F3XN,2,17,0,0,19
957561,10/15 09:44 AM,F3N,84,133,0,0,217
957560,10/15 09:44 AM,F3XA,0,0,0,21,21
957559,10/15 09:43 AM,F3XN,0,3,0,0,3
957557,10/15 09:43 AM,F3XN,0,0,0,0,0
957556,10/15 09:43 AM,F3XN,1,7,0,0,8
957555,10/15 09:42 AM,F3XN,0,0,0,0,0
957554,10/15 09:42 AM,F3N,15,42,0,2,59
957553,10/15 09:42 AM,F3XN,0,2,0,0,2
957552,10/15 09:41 AM,F3XN,0,0,0,0,0
957551,10/15 09:41 AM,F3N,4,11,0,0,15
957550,10/15 09:39 AM,F3XN,1,5,0,0,6
957549,10/15 09:39 AM,F3N,0,0,0,0,0
957548,10/15 09:39 AM,F3XN,550,35,0,1,586
957547,10/15 09:37 AM,F3XN,0,0,0,0,0
957546,10/15 09:36 AM,F3N,0,0,0,15,15
957545,10/15 09:33 AM,F3XN,15,44,0,0,59
957544,10/15 09:33 AM,F3XN,1,5,0,0,6
957543,10/15 09:33 AM,F3XN,0,0,0,21,21
957542,10/15 09:32 AM,F3XN,26,13,0,0,39
957541,10/15 09:32 AM,F3A,60,45,0,0,105
957540,10/15 09:30 AM,F3XN,0,0,0,0,0
957539,10/15 09:29 AM,F3N,12,5,0,2,19
957538,10/15 09:28 AM,F3N,16,9,0,8,33
957537,10/15 09:27 AM,F3XN,9,8,0,0,17
957535,10/15 09:27 AM,F3XN,95,1,0,0,96
957533,10/15 09:26 AM,F3N,398,159,0,0,557
957532,10/15 09:26 AM,F3N,0,0,0,0,0
957531,10/15 09:25 AM,F3XN,55,35,0,0,90
957530,10/15 09:25 AM,F3XN,14,12,0,0,26
957529,10/15 09:25 AM,F3XN,38,2,0,0,40
957528,10/15 09:24 AM,F3XN,3,18,0,0,21
957527,10/15 09:24 AM,F3N,6,10,0,0,16
957526,10/15 09:22 AM,F3XA,200,24,0,0,224
957525,10/15 09:21 AM,F5N,0,0,0,0,0
957524,10/15 09:20 AM,F3N,0,0,0,14,14
957523,10/15 09:20 AM,F3XN,40,1,0,0,41
957522,10/15 09:18 AM,F3XN,33,6,0,0,39
957521,10/15 09:18 AM,F3XN,389,314,0,7,710
957520,10/15 09:18 AM,F3T,0,0,0,0,0
957519,10/15 09:18 AM,F3XN,406,43,0,0,449
957518,10/15 09:17 AM,F3N,0,8,0,0,8
957517,10/15 09:17 AM,F3N,30,38,0,0,68
957516,10/15 09:16 AM,F3XN,4,12,0,0,16
957515,10/15 09:16 AM,F3XN,132,27,0,0,159
957513,10/15 09:14 AM,F3N,7,49,0,43,99
957512,10/15 09:12 AM,F3XN,22459,16803,0,348,39610
957511,10/15 09:11 AM,F3XN,1,0,0,0,1
957510,10/15 09:11 AM,F3XN,0,0,0,0,0
957509,10/15 09:10 AM,F3XN,1065,15,0,0,1080
957508,10/15 09:09 AM,F3XN,0,3,0,19,22
957507,10/15 09:08 AM,F3N,0,1,0,0,1
957506,10/15 09:06 AM,F3N,241,43,0,178,462
957505,10/15 09:06 AM,F5N,2,0,2,0,4
957504,10/15 09:03 AM,F3N,5,3,0,2,10
957503,10/15 09:02 AM,F3XN,0,0,110,52,162
957502,10/15 09:02 AM,F3XN,200,23,0,0,223
957501,10/15 09:00 AM,F3N,965,38,0,736,1739
957500,10/15 08:56 AM,F3XN,0,7,0,0,7
957499,10/15 08:55 AM,F3N,27,15,0,11,53
957498,10/15 08:55 AM,F3XN,0,0,0,0,0
957497,10/15 08:55 AM,F3XN,0,13,0,0,13
957496,10/15 08:54 AM,F3N,1,1,0,0,2
957495,10/15 08:53 AM,F3XN,0,0,0,0,0
957494,10/15 08:53 AM,F1N,0,0,0,0,0
957493,10/15 08:52 AM,F3XN,497,278,0,22,797
957492,10/15 08:52 AM,F3XN,0,17,0,0,17
957491,10/15 08:52 AM,F3XN,66,21,0,0,87
957490,10/15 08:49 AM,F3XN,1,6,0,0,7
957489,10/15 08:46 AM,F3XN,18,20,0,1,39
957488,10/15 08:46 AM,F3XN,0,1,0,0,1
957487,10/15 08:46 AM,F3XN,69,13,0,0,82
957486,10/15 08:43 AM,F3XN,0,7,0,0,7
957485,10/15 08:40 AM,F3XN,15,1,0,0,16
957484,10/15 08:39 AM,F3XN,2,0,0,0,2
957483,10/15 08:38 AM,F3XN,2,3,0,3,8
957482,10/15 08:36 AM,F3N,0,2,0,0,2
957481,10/15 08:34 AM,F3N,0,1,0,0,1
957480,10/15 08:34 AM,F3XN,5,6,0,0,11
957479,10/15 08:31 AM,F3XN,170,1,0,0,171
957478,10/15 08:31 AM,F3XN,0,0,0,0,0
957477,10/15 08:29 AM,F3XN,40,12,0,0,52
957476,10/15 08:28 AM,F3XN,0,0,0,0,0
957475,10/15 08:25 AM,F3N,304,216,0,0,520
957474,10/15 08:24 AM,F3N,0,0,0,2,2
957473,10/15 08:17 AM,F3N,0,0,0,4,4
957472,10/15 08:11 AM,F3XN,0,1,0,0,1
957471,10/15 08:09 AM,F3XN,0,4,0,3,7
957470,10/15 08:09 AM,F3XN,108,3,0,0,111
957469,10/15 08:06 AM,F3N,581,166,0,0,747
957468,10/15 07:59 AM,F3N,0,0,0,1,1
957467,10/15 07:57 AM,F3N,544,147,0,16,707
957466,10/15 07:55 AM,F3XN,4,3,0,0,7
957465,10/15 07:53 AM,F3N,0,0,0,0,0
957464,10/15 07:51 AM,F3N,31,46,0,0,77
957463,10/15 07:48 AM,F3N,0,0,0,1,1
957462,10/15 07:47 AM,F3N,166,102,0,0,268
957461,10/15 07:44 AM,F3N,678,165,0,8,851
957460,10/15 07:43 AM,F3N,192,240,0,3,435
957459,10/15 07:40 AM,F3XN,0,0,0,0,0
957458,10/15 07:30 AM,F3XN,0,3,0,0,3
957457,10/15 07:28 AM,F3XN,0,2,0,0,2
957456,10/15 07:27 AM,F3N,18,18,0,0,36
957455,10/15 07:10 AM,F3XN,24,23,0,0,47
957454,10/15 07:03 AM,F3XN,0,0,0,0,0
957453,10/15 06:59 AM,F3XN,0,0,0,0,0
957452,10/15 06:10 AM,F3XN,12,21,0,16,49
957451,10/15 05:57 AM,F3XN,98,84,1,3,186
957450,10/15 05:32 AM,F3N,153,124,0,0,277
957449,10/15 05:19 AM,F3XN,37,27,0,5,69
957448,10/15 04:52 AM,F3N,7,35,0,0,42
957447,10/15 04:47 AM,F3T,0,1,0,0,1
957446,10/15 04:38 AM,F3T,0,1,0,0,1
957445,10/15 04:28 AM,F3T,0,1,0,0,1
957444,10/15 04:25 AM,F3XN,13,2,0,0,15
957443,10/15 04:20 AM,F3N,0,3,0,0,3
957442,10/15 04:12 AM,F3N,0,0,0,0,0
957441,10/15 04:02 AM,F3N,0,0,0,0,0
957440,10/15 03:53 AM,F3A,72,9,0,1,82
957439,10/15 03:52 AM,F3XN,1,0,0,0,1
957438,10/15 03:45 AM,F3XN,0,0,0,0,0
957437,10/15 03:38 AM,F3XN,7,1,0,0,8
957436,10/15 03:24 AM,F3XN,0,0,0,2,2
957435,10/15 03:20 AM,F3XN,0,9,0,0,9
957434,10/15 03:13 AM,F3XN,0,0,0,0,0
957433,10/15 03:12 AM,F3XN,0,0,0,0,0
957432,10/15 03:10 AM,F3XN,0,0,0,0,0
957431,10/15 03:09 AM,F3A,16,86,0,0,102
957430,10/15 03:06 AM,F3A,137,107,0,0,244
957429,10/15 03:06 AM,F3XN,193,8,0,0,201
957428,10/15 03:05 AM,F3A,45,124,0,0,169
957427,10/15 02:57 AM,F3XN,10,12,0,0,22
957426,10/15 02:57 AM,F3N,3,120,0,6,129
957425,10/15 02:27 AM,F3N,2,24,0,0,26
957424,10/15 02:09 AM,F3N,0,0,0,0,0
957423,10/15 02:06 AM,F3N,0,0,0,0,0
957422,10/15 02:02 AM,F3XN,0,10,0,0,10
957421,10/15 01:56 AM,F3XN,0,3,0,0,3
957420,10/15 01:53 AM,F3XN,0,0,0,0,0
957419,10/15 01:35 AM,F3XN,0,7,0,0,7
957418,10/15 01:33 AM,F3XN,0,3,0,0,3
957417,10/15 01:28 AM,F3XN,230,32,0,0,262
957416,10/15 01:25 AM,F3XN,0,2,0,0,2
957415,10/15 01:22 AM,F3XN,6,16,0,0,22
957414,10/15 01:19 AM,F3A,32,26,0,47,105
957413,10/15 01:18 AM,F3XN,0,0,0,52,52
957412,10/15 01:16 AM,F3XN,0,0,0,0,0
957411,10/15 01:15 AM,F3XN,0,0,0,3,3
957410,10/15 01:11 AM,F3XN,1,0,0,0,1
957409,10/15 01:06 AM,F3XN,0,0,0,1,1
957408,10/15 01:03 AM,F3XN,0,6,0,0,6
957407,10/15 01:00 AM,F3XN,20,17,0,0,37
957406,10/15 01:00 AM,F3XN,360,7,0,0,367
957405,10/15 12:56 AM,F3XN,0,3,0,1,4
957404,10/15 12:56 AM,F3XN,119,0,0,4,123
957403,10/15 12:56 AM,F3XN,0,1,0,0,1
957402,10/15 12:49 AM,F3XN,0,0,0,1,1
957401,10/15 12:47 AM,F3N,3,1,0,1,5
957400,10/15 12:47 AM,F3A,0,3,0,0,3
957399,10/15 12:46 AM,F3XN,7,6,0,3,16
957398,10/15 12:44 AM,F3XN,0,4,0,1,5
957397,10/15 12:43 AM,F3XN,0,0,0,1,1
957396,10/15 12:42 AM,F3XN,46,45,0,0,91
957395,10/15 12:37 AM,F3XN,282,1,0,0,283
957394,10/15 12:37 AM,F3XN,85,7,0,0,92
957393,10/15 12:34 AM,F3XN,5,7,0,0,12
957392,10/15 12:33 AM,F3XN,0,0,0,0,0
957391,10/15 12:32 AM,F3XN,2,18,0,0,20
957390,10/15 12:29 AM,F3N,40,92,0,0,132
957389,10/15 12:27 AM,F3XN,0,3,0,1,4
957388,10/15 12:27 AM,F3XN,0,0,0,0,0
957387,10/15 12:21 AM,F3N,43,61,0,3,107
957386,10/15 12:20 AM,F3XN,0,6,0,0,6
957385,10/15 12:11 AM,F3N,0,0,0,12,12
957384,10/15 12:06 AM,F3XN,13,10,0,0,23
957383,10/15 12:05 AM,F3XT,0,3,0,2,5
957382,10/15 12:05 AM,F3N,2,1,0,7,10
957381,10/15 12:01 AM,F3XN,39,34,0,11,84
957380,10/15 12:00 AM,F3XN,0,0,0,0,0
