filing_number,time_filed,form_type,skeda_lines,skedb_lines,skede_lines,other_lines,total_lines
963328,10/20 11:57 PM,F3XN,164,72,0,0,236
963327,10/20 11:54 PM,F3XA,16,0,0,28,44
963326,10/20 11:51 PM,F3XN,44,18,0,19,81
963325,10/20 11:45 PM,F3XN,0,0,0,0,0
963324,10/20 11:42 PM,F3XN,0,4,0,0,4
963323,10/20 11:41 PM,F3XN,7,17,0,0,24
963322,10/20 11:39 PM,F3XN,0,0,0,1,1
963321,10/20 11:38 PM,F3XN,67,164,0,0,231
963320,10/20 11:37 PM,F3N,7,14,0,0,21
963319,10/20 11:37 PM,F3XN,1662,153,0,0,1815
963318,10/20 11:37 PM,F3XN,1,5,0,0,6
963317,10/20 11:37 PM,F3XN,1,6,0,0,7
963316,10/20 11:37 PM,F6N,16,0,0,0,16
963315,10/20 11:32 PM,F3XN,109,79,0,455,643
963314,10/20 11:24 PM,F3XN,52,102,0,9,163
963313,10/20 11:22 PM,F3XN,390,330,0,192,912
963312,10/20 11:22 PM,F6N,1,0,0,0,1
963311,10/20 11:20 PM,F3XN,2,16,0,112,130
963310,10/20 11:19 PM,F6N,1,0,0,0,1
963309,10/20 11:17 PM,F24N,0,0,2,0,2
963308,10/20 11:16 PM,F24N,0,0,154,0,154
963307,10/20 11:14 PM,F6N,1,0,0,0,1
963306,10/20 11:13 PM,F3XN,219,12,0,0,231
963305,10/20 11:11 PM,F3XN,9,30,0,0,39
963304,10/20 11:10 PM,F3XN,9,16,0,0,25
963303,10/20 11:09 PM,F3XN,116,313,0,307,736
963302,10/20 11:09 PM,F3XN,1084,83,0,24,1191
963301,10/20 11:08 PM,F3XN,1075,365,0,396,1836
963300,10/20 11:07 PM,F3XN,137,21,0,122,280
963299,10/20 11:05 PM,F6N,5,0,0,0,5
963298,10/20 11:05 PM,F6N,1,0,0,0,1
963297,10/20 11:03 PM,F3XN,121,31,0,23,175
963296,10/20 11:03 PM,F6N,10,0,0,0,10
963295,10/20 11:02 PM,F3XN,92,52,0,17,161
963294,10/20 11:00 PM,F6N,3,0,0,0,3
963293,10/20 11:00 PM,F3XN,8,2,0,0,10
963292,10/20 10:57 PM,F3XN,223,137,31,2,393
963291,10/20 10:54 PM,F3XN,1839,238,174,23,2274
963290,10/20 10:53 PM,F3XN,15,6,0,0,21
963289,10/20 10:51 PM,F3XN,105,131,0,17,253
963288,10/20 10:43 PM,F3XN,1,1,0,0,2
963287,10/20 10:43 PM,F3XN,608,306,0,23,937
963286,10/20 10:43 PM,F3XN,2,0,0,0,2
963285,10/20 10:41 PM,F6N,18,0,0,0,18
963284,10/20 10:41 PM,F6N,5,0,0,0,5
963283,10/20 10:41 PM,F3XN,0,0,0,0,0
963282,10/20 10:39 PM,F3XN,85,194,0,157,436
963281,10/20 10:37 PM,F3XN,1,0,0,0,1
963280,10/20 10:34 PM,F3XN,1,0,0,0,1
963279,10/20 10:32 PM,F3XN,73,13,0,11,97
963278,10/20 10:29 PM,F6N,9,0,0,0,9
963277,10/20 10:29 PM,F3XN,78,19,0,46,143
963276,10/20 10:29 PM,F6N,5,0,0,0,5
963275,10/20 10:26 PM,F3XN,45,19,0,14,78
963274,10/20 10:25 PM,F3XN,236,455,0,108,799
963273,10/20 10:24 PM,F3XN,74,81,0,7,162
963272,10/20 10:22 PM,F3XN,21,9,0,0,30
963271,10/20 10:18 PM,F3N,1,3,0,2,6
963270,10/20 10:17 PM,F6N,2,0,0,0,2
963269,10/20 10:16 PM,F3XN,2993,2782,45,0,5820
963268,10/20 10:16 PM,F3XN,0,12,0,0,12
963267,10/20 10:16 PM,F6N,4,0,0,0,4
963266,10/20 10:15 PM,F6N,2,0,0,0,2
963265,10/20 10:10 PM,F3XN,157,109,0,0,266
963264,10/20 10:09 PM,F3XN,164,415,0,50,629
963263,10/20 10:08 PM,F24N,0,0,1,0,1
963262,10/20 10:08 PM,F6N,6,0,0,0,6
963261,10/20 10:07 PM,F6N,5,0,0,0,5
963260,10/20 10:04 PM,F3N,1873,85,0,0,1958
963259,10/20 10:04 PM,F6N,3,0,0,0,3
963258,10/20 10:04 PM,F6N,5,0,0,0,5
963257,10/20 10:02 PM,F3XN,205,15,0,0,220
963256,10/20 10:01 PM,F6N,1,0,0,0,1
963255,10/20 10:01 PM,F3XN,80,24,0,37,141
963254,10/20 10:01 PM,F6N,2,0,0,0,2
963253,10/20 10:01 PM,F3XA,343,156,35,1,535
963252,10/20 10:00 PM,F6N,4,0,0,0,4
963251,10/20 09:59 PM,F6N,5,0,0,0,5
963250,10/20 09:59 PM,F3XN,110,75,0,103,288
963249,10/20 09:57 PM,F3XN,75,84,0,30,189
963248,10/20 09:57 PM,F3XN,11,8,0,25,44
963247,10/20 09:55 PM,F3XN,0,0,0,0,0
963246,10/20 09:54 PM,F3XN,28,64,0,77,169
963245,10/20 09:49 PM,F3A,303,167,0,4,474
963244,10/20 09:43 PM,F3XN,4,5,0,0,9
963243,10/20 09:42 PM,F3N,106,25,0,1,132
963242,10/20 09:39 PM,F3XN,5,6,0,0,11
963241,10/20 09:37 PM,F6N,1,0,0,0,1
963240,10/20 09:36 PM,F3XN,13,36,0,0,49
963239,10/20 09:34 PM,F3XA,220,124,0,1,345
963238,10/20 09:34 PM,F3XN,385,260,0,207,852
963237,10/20 09:30 PM,F6N,1,0,0,0,1
963236,10/20 09:28 PM,F3XN,0,1,0,0,1
963235,10/20 09:27 PM,F6N,4,0,0,0,4
963234,10/20 09:26 PM,F3XN,0,0,0,0,0
963233,10/20 09:25 PM,F3XN,14,329,62,6,411
963232,10/20 09:18 PM,F6N,1,0,0,0,1
963231,10/20 09:18 PM,F3XN,10,2,0,19,31
963230,10/20 09:17 PM,F6N,3,0,0,0,3
963229,10/20 09:16 PM,F3N,11,8,0,2,21
963228,10/20 09:16 PM,F3XA,22,167,143,6,338
963227,10/20 09:15 PM,F6N,1,0,0,0,1
963226,10/20 09:15 PM,F6N,7,0,0,0,7
963225,10/20 09:14 PM,F3A,113,146,0,0,259
963224,10/20 09:14 PM,F3XN,5,4,0,13,22
963223,10/20 09:13 PM,F3XN,218,31,0,189,438
963222,10/20 09:10 PM,F24N,0,0,2,0,2
963221,10/20 09:07 PM,F3XN,141,40,0,8,189
963220,10/20 09:07 PM,F6N,4,0,0,0,4
963219,10/20 09:01 PM,F3XN,4,5,0,0,9
963218,10/20 09:00 PM,F6N,3,0,0,0,3
963217,10/20 08:59 PM,F3XN,27,36,0,43,106
963216,10/20 08:59 PM,F3XN,117,242,0,341,700
963215,10/20 08:59 PM,F3XN,1344,157,3,26,1530
963214,10/20 08:59 PM,F3XN,16,12,0,2,30
963213,10/20 08:57 PM,F6N,5,0,0,0,5
963212,10/20 08:54 PM,F6N,8,0,0,0,8
963211,10/20 08:54 PM,F3XN,512,25,0,81,618
963210,10/20 08:52 PM,F3N,0,0,0,11,11
963209,10/20 08:52 PM,F99,0,0,0,0,0
963208,10/20 08:50 PM,F3XN,10,19,0,0,29
963207,10/20 08:50 PM,F3XN,0,0,0,0,0
963206,10/20 08:49 PM,F3XN,13,20,0,0,33
963205,10/20 08:46 PM,F6N,2,0,0,0,2
963204,10/20 08:45 PM,F3A,84,55,0,0,139
963203,10/20 08:44 PM,F3XN,0,0,0,0,0
963202,10/20 08:42 PM,F6N,2,0,0,0,2
963201,10/20 08:40 PM,F3XN,10,18,0,0,28
963200,10/20 08:39 PM,F3XN,31,14,0,0,45
963199,10/20 08:35 PM,F3XN,62,5,0,62,129
963198,10/20 08:34 PM,F6N,1,0,0,0,1
963197,10/20 08:34 PM,F3XN,31,182,0,90,303
963196,10/20 08:33 PM,F3XN,0,1,0,0,1
963195,10/20 08:32 PM,F6N,1,0,0,0,1
963194,10/20 08:32 PM,F3N,15,31,0,0,46
963193,10/20 08:32 PM,F3XN,295,21,0,95,411
963192,10/20 08:30 PM,F3N,50,11,0,3,64
963191,10/20 08:28 PM,F3XN,49,148,0,217,414
963190,10/20 08:28 PM,F5N,1,0,1,0,2
963189,10/20 08:27 PM,F3XN,6,1,0,0,7
963188,10/20 08:27 PM,F6N,6,0,0,0,6
963187,10/20 08:26 PM,F3XA,6,15,0,0,21
963186,10/20 08:24 PM,F3XN,224,23,0,80,327
963185,10/20 08:24 PM,F3XN,196,165,0,182,543
963184,10/20 08:23 PM,F6N,4,0,0,0,4
963183,10/20 08:23 PM,F3XN,315,22,0,0,337
963182,10/20 08:23 PM,F3XN,0,0,0,0,0
963181,10/20 08:18 PM,F3XN,111,43,0,90,244
963180,10/20 08:17 PM,F3XN,21,2,0,0,23
963179,10/20 08:17 PM,F3XN,125,191,0,114,430
963178,10/20 08:17 PM,F6N,2,0,0,0,2
963177,10/20 08:14 PM,F6N,3,0,0,0,3
963176,10/20 08:14 PM,F3XN,78,27,0,91,196
963175,10/20 08:14 PM,F6N,1,0,0,0,1
963174,10/20 08:11 PM,F6N,5,0,0,0,5
963173,10/20 08:06 PM,F3XN,0,0,0,0,0
963172,10/20 08:06 PM,F6N,3,0,0,0,3
963171,10/20 08:05 PM,F3N,0,0,0,0,0
963170,10/20 08:04 PM,F6N,1,0,0,0,1
963169,10/20 08:02 PM,F3XN,0,5,0,0,5
963168,10/20 08:02 PM,F3XN,21,1,0,21,43
963167,10/20 08:02 PM,F3XN,10,0,0,48,58
963166,10/20 08:01 PM,F6N,4,0,0,0,4
963165,10/20 08:00 PM,F6N,11,0,0,0,11
963164,10/20 08:00 PM,F6N,6,0,0,0,6
963163,10/20 08:00 PM,F3XA,5138,822,67,7,6034
963162,10/20 08:00 PM,F3XN,13,2,0,1,16
963161,10/20 08:00 PM,F3N,4,8,0,11,23
963160,10/20 07:55 PM,F3XN,199,24,0,201,424
963159,10/20 07:53 PM,F3XN,5,18,0,0,23
963158,10/20 07:53 PM,F3XN,197,67,0,44,308
963157,10/20 07:53 PM,F3XN,32,0,0,0,32
963156,10/20 07:52 PM,F3XN,0,8,0,0,8
963155,10/20 07:51 PM,F3XN,0,0,0,0,0
963154,10/20 07:49 PM,F3XN,10,0,0,0,10
963153,10/20 07:49 PM,F24N,0,0,42,0,42
963152,10/20 07:48 PM,F3XN,29,34,21,0,84
963151,10/20 07:48 PM,F24A,0,0,15,0,15
963150,10/20 07:48 PM,F99,0,0,0,0,0
963149,10/20 07:47 PM,F3XN,238,14,0,0,252
963148,10/20 07:47 PM,F3XN,1,3,0,0,4
963147,10/20 07:47 PM,F24A,0,0,15,0,15
963146,10/20 07:47 PM,F3XN,3,15,0,0,18
963145,10/20 07:45 PM,F99,0,0,0,0,0
963144,10/20 07:44 PM,F6N,4,0,0,0,4
963143,10/20 07:43 PM,F6N,2,0,0,0,2
963142,10/20 07:43 PM,F3N,43,9,0,0,52
963141,10/20 07:42 PM,F3XN,0,2,0,0,2
963140,10/20 07:42 PM,F24N,0,0,1,0,1
963139,10/20 07:41 PM,F3XN,22,1,0,0,23
963138,10/20 07:41 PM,F3XN,3,0,0,1,4
963137,10/20 07:41 PM,F3XN,0,0,0,0,0
963136,10/20 07:41 PM,F24N,0,0,1,0,1
963135,10/20 07:39 PM,F6N,2,0,0,0,2
963134,10/20 07:38 PM,F24N,0,0,1,0,1
963133,10/20 07:37 PM,F6N,1,0,0,0,1
963132,10/20 07:37 PM,F3XN,3,1,0,0,4
963131,10/20 07:36 PM,F24N,0,0,1,0,1
963130,10/20 07:35 PM,F3XN,79,1,0,0,80
963129,10/20 07:35 PM,F3XN,55,52,0,0,107
963128,10/20 07:35 PM,F3XN,57,4,0,1,62
963127,10/20 07:34 PM,F3XN,6,1,0,0,7
963126,10/20 07:33 PM,F6N,10,0,0,0,10
963125,10/20 07:33 PM,F3XN,0,0,0,0,0
963124,10/20 07:33 PM,F24N,0,0,1,0,1
963123,10/20 07:31 PM,F6N,1,0,0,0,1
963122,10/20 07:29 PM,F3XN,24,0,0,0,24
963121,10/20 07:29 PM,F3XA,26,9,0,0,35
963120,10/20 07:29 PM,F3XN,0,168,0,0,168
963119,10/20 07:29 PM,F3XN,22,4,0,21,47
963118,10/20 07:27 PM,F3XN,0,1,0,0,1
963117,10/20 07:27 PM,F3XN,0,3,0,0,3
963116,10/20 07:25 PM,F3XN,13,0,0,0,13
963115,10/20 07:25 PM,F3XN,92,0,0,168,260
963114,10/20 07:25 PM,F3XN,2,1,0,0,3
963113,10/20 07:24 PM,F3XN,1,105,0,0,106
963112,10/20 07:22 PM,F24N,0,0,1,0,1
963111,10/20 07:22 PM,F3XN,36,0,0,0,36
963110,10/20 07:21 PM,F3XN,146,16,0,2,164
963109,10/20 07:20 PM,F3XN,853,227,0,174,1254
963108,10/20 07:20 PM,F3XN,0,0,0,0,0
963107,10/20 07:20 PM,F6N,1,0,0,0,1
963106,10/20 07:19 PM,F6N,2,0,0,0,2
963105,10/20 07:19 PM,F6N,2,0,0,0,2
963104,10/20 07:18 PM,F3N,15,20,0,4,39
963103,10/20 07:18 PM,F3XN,461,291,0,508,1260
963102,10/20 07:17 PM,F3XN,0,1,0,0,1
963101,10/20 07:16 PM,F3XN,26,13,0,56,95
963100,10/20 07:14 PM,F3XN,0,1,0,0,1
963099,10/20 07:14 PM,F24N,0,0,1,0,1
963098,10/20 07:13 PM,F6N,16,0,0,0,16
963097,10/20 07:13 PM,F24N,0,0,1,0,1
963096,10/20 07:12 PM,F3XN,0,1,0,0,1
963095,10/20 07:10 PM,F3XN,0,0,0,0,0
963094,10/20 07:10 PM,F3XN,13,4,3,0,20
963093,10/20 07:09 PM,F3XN,2,4,0,0,6
963092,10/20 07:08 PM,F3XN,2,24,0,0,26
963091,10/20 07:08 PM,F3XN,76,60,0,0,136
963090,10/20 07:07 PM,F3A,260,132,0,5,397
963089,10/20 07:06 PM,F3XN,11,9,0,0,20
963088,10/20 07:06 PM,F1N,0,0,0,0,0
963087,10/20 07:06 PM,F3XN,7102,6998,0,1,14101
963086,10/20 07:04 PM,F3XN,11,13,0,0,24
963085,10/20 07:04 PM,F6N,1,0,0,0,1
963084,10/20 07:03 PM,F1A,0,0,0,0,0
963083,10/20 07:03 PM,F3XN,100,4,0,0,104
963082,10/20 07:02 PM,F3XN,84,39,0,123,246
963081,10/20 07:01 PM,F6N,1,0,0,0,1
963080,10/20 07:01 PM,F3XN,2,4,0,0,6
963079,10/20 07:00 PM,F3XN,18,35,0,0,53
963078,10/20 07:00 PM,F3XN,49,20,0,33,102
963077,10/20 06:59 PM,F3XN,0,15,0,0,15
963076,10/20 06:59 PM,F6N,9,0,0,0,9
963075,10/20 06:58 PM,F24N,0,0,9,0,9
963074,10/20 06:58 PM,F3XA,54,8,0,26,88
963073,10/20 06:56 PM,F3XN,4,12,0,0,16
963072,10/20 06:54 PM,F3XN,91,22,0,0,113
963071,10/20 06:54 PM,F6N,3,0,0,0,3
963070,10/20 06:53 PM,F6N,1,0,0,0,1
963069,10/20 06:52 PM,F3XN,2,7,0,2,11
963068,10/20 06:51 PM,F6N,1,0,0,0,1
963067,10/20 06:51 PM,F24N,0,0,6,0,6
963066,10/20 06:50 PM,F6N,13,0,0,0,13
963065,10/20 06:48 PM,F6N,3,0,0,0,3
963064,10/20 06:48 PM,F6N,7,0,0,0,7
963063,10/20 06:47 PM,F6N,3,0,0,0,3
963062,10/20 06:46 PM,F3XN,28,4,0,0,32
963061,10/20 06:44 PM,F3XN,0,0,0,0,0
963060,10/20 06:44 PM,F6N,3,0,0,0,3
963059,10/20 06:44 PM,F6N,1,0,0,0,1
963058,10/20 06:42 PM,F6A,10,0,0,0,10
963057,10/20 06:42 PM,F6N,4,0,0,0,4
963056,10/20 06:41 PM,F3XN,10,34,0,0,44
963055,10/20 06:39 PM,F3XN,16,3,0,39,58
963054,10/20 06:39 PM,F99,0,0,0,0,0
963053,10/20 06:39 PM,F3XN,1690,69,2,0,1761
963052,10/20 06:38 PM,F3XN,175,3,0,0,178
963051,10/20 06:38 PM,F3XN,968,28,0,0,996
963050,10/20 06:37 PM,F3XN,223,25,0,92,340
963049,10/20 06:36 PM,F3XA,21,24,0,32,77
963048,10/20 06:35 PM,F3XN,233,158,0,100,491
963047,10/20 06:35 PM,F6N,9,0,0,0,9
963046,10/20 06:35 PM,F3N,83,42,0,0,125
963045,10/20 06:34 PM,F6N,8,0,0,0,8
963044,10/20 06:34 PM,F3XN,93,100,0,0,193
963043,10/20 06:33 PM,F3XN,271,18,0,0,289
963042,10/20 06:33 PM,F3XA,70,135,0,112,317
963041,10/20 06:32 PM,F6N,1,0,0,0,1
963040,10/20 06:30 PM,F6N,1,0,0,0,1
963039,10/20 06:29 PM,F3XN,10813,644,207,32,11696
963038,10/20 06:29 PM,F3XN,81,11,1,0,93
963037,10/20 06:28 PM,F3XN,333,180,0,53,566
963036,10/20 06:28 PM,F3XN,42,14,0,0,56
963035,10/20 06:28 PM,F3XN,33831,1449,0,9,35289
963034,10/20 06:27 PM,F3XN,1,6,4,0,11
963033,10/20 06:26 PM,F6N,5,0,0,0,5
963032,10/20 06:24 PM,F3XN,892,101,13,1,1007
963031,10/20 06:24 PM,F6N,1,0,0,0,1
963030,10/20 06:23 PM,F6N,2,0,0,0,2
963029,10/20 06:23 PM,F3XN,130,14,0,1,145
963028,10/20 06:23 PM,F6N,1,0,0,0,1
963027,10/20 06:23 PM,F3XN,3,13,0,0,16
963026,10/20 06:23 PM,F3XN,17,7,0,20,44
963025,10/20 06:22 PM,F24N,0,0,1,0,1
963024,10/20 06:22 PM,F3XN,211,131,75,0,417
963023,10/20 06:22 PM,F3XN,632,116,0,7,755
963022,10/20 06:21 PM,F3XN,16,36,0,0,52
963021,10/20 06:21 PM,F3A,98,162,0,1,261
963020,10/20 06:21 PM,F3XA,0,1,1,0,2
963019,10/20 06:21 PM,F6N,3,0,0,0,3
963018,10/20 06:20 PM,F24N,0,0,1,0,1
963017,10/20 06:17 PM,F3XN,0,2,0,0,2
963016,10/20 06:17 PM,F3XN,17244,15113,49,1,32407
963015,10/20 06:16 PM,F3XA,126,103,0,41,270
963014,10/20 06:16 PM,F24A,0,0,1,0,1
963013,10/20 06:15 PM,F99,0,0,0,0,0
963012,10/20 06:14 PM,F3XN,351,23,0,0,374
963011,10/20 06:11 PM,F3XN,92,13,0,0,105
963010,10/20 06:10 PM,F6N,1,0,0,0,1
963009,10/20 06:10 PM,F6N,1,0,0,0,1
963008,10/20 06:09 PM,F3XN,613,93,0,0,706
963007,10/20 06:08 PM,F3XN,70,135,0,113,318
963006,10/20 06:08 PM,F3XN,1,1,1,1,4
963005,10/20 06:07 PM,F6N,4,0,0,0,4
963004,10/20 06:06 PM,F3XN,0,6,0,0,6
963003,10/20 06:06 PM,F3XN,671,373,0,635,1679
963002,10/20 06:05 PM,F3XN,228,54,0,1,283
963001,10/20 06:04 PM,F3XN,53,2,0,0,55
963000,10/20 06:04 PM,F3XN,32,51,0,0,83
962999,10/20 06:03 PM,F3XN,0,0,0,0,0
962998,10/20 06:03 PM,F6N,3,0,0,0,3
962997,10/20 06:02 PM,F3XN,0,0,0,0,0
962996,10/20 06:02 PM,F3XN,0,5,0,0,5
962995,10/20 06:01 PM,F3XN,0,0,0,0,0
962994,10/20 06:01 PM,F24N,0,0,7,0,7
962993,10/20 06:00 PM,F3XN,8,2,0,30,40
962992,10/20 06:00 PM,F6N,1,0,0,0,1
962991,10/20 06:00 PM,F3XN,62,79,0,0,141
962990,10/20 05:59 PM,F3XN,11,1,0,0,12
962989,10/20 05:59 PM,F6N,4,0,0,0,4
962988,10/20 05:58 PM,F3N,47,41,0,0,88
962987,10/20 05:57 PM,F3XN,30,4,0,113,147
962986,10/20 05:56 PM,F3XN,1173,52,0,0,1225
962985,10/20 05:56 PM,F3XN,52,0,0,0,52
962984,10/20 05:56 PM,F3XN,1,5,0,0,6
962983,10/20 05:55 PM,F3XN,0,0,0,0,0
962982,10/20 05:55 PM,F3XN,224,62,0,1,287
962981,10/20 05:53 PM,F3XN,0,9,0,0,9
962980,10/20 05:53 PM,F3XN,14,2,0,0,16
962979,10/20 05:53 PM,F3XN,0,15,0,0,15
962978,10/20 05:50 PM,F3XN,19,41,0,0,60
962977,10/20 05:50 PM,F3XN,1324,72,41,11,1448
962976,10/20 05:49 PM,F3XN,1803,316,88,4,2211
962975,10/20 05:48 PM,F3XN,5,17,0,0,22
962974,10/20 05:48 PM,F6N,7,0,0,0,7
962973,10/20 05:48 PM,F3XN,0,0,0,0,0
962972,10/20 05:47 PM,F3XN,587,86,0,0,673
962971,10/20 05:47 PM,F3XA,1696,37,2,2,1737
962970,10/20 05:46 PM,F6N,1,0,0,0,1
962969,10/20 05:46 PM,F3XN,0,0,0,0,0
962968,10/20 05:46 PM,F6N,1,0,0,0,1
962967,10/20 05:46 PM,F3XN,0,1,0,0,1
962966,10/20 05:46 PM,F3XN,11,62,0,0,73
962965,10/20 05:45 PM,F3XN,86,0,0,0,86
962964,10/20 05:45 PM,F6N,1,0,0,0,1
962963,10/20 05:45 PM,F3XN,10,3,0,1,14
962962,10/20 05:45 PM,F3XN,1,1,0,0,2
962961,10/20 05:45 PM,F99,0,0,0,0,0
962960,10/20 05:44 PM,F3XN,0,0,0,0,0
962959,10/20 05:44 PM,F6N,16,0,0,0,16
962958,10/20 05:43 PM,F3XN,0,4,0,0,4
962957,10/20 05:43 PM,F6N,1,0,0,0,1
962956,10/20 05:43 PM,F6N,3,0,0,0,3
962955,10/20 05:42 PM,F3XN,189,1,0,0,190
962954,10/20 05:42 PM,F3XN,2,3,0,0,5
962953,10/20 05:41 PM,F3XN,1,0,0,0,1
962952,10/20 05:40 PM,F6N,7,0,0,0,7
962951,10/20 05:40 PM,F3XN,9,52,0,0,61
962950,10/20 05:38 PM,F3XN,0,0,0,0,0
962949,10/20 05:37 PM,F3XN,117,48,0,43,208
962948,10/20 05:36 PM,F3XN,0,0,0,0,0
962947,10/20 05:36 PM,F3XN,80,9,0,1,90
962946,10/20 05:35 PM,F6N,6,0,0,0,6
962945,10/20 05:34 PM,F3XN,5,0,0,0,5
962944,10/20 05:34 PM,F6N,8,0,0,0,8
962943,10/20 05:33 PM,F3XN,8,4,0,0,12
962942,10/20 05:33 PM,F3XN,155,3,0,0,158
962941,10/20 05:33 PM,F3XN,478,46,0,1,525
962940,10/20 05:32 PM,F6N,5,0,0,0,5
962939,10/20 05:32 PM,F3XN,0,0,0,0,0
962938,10/20 05:31 PM,F3XN,1,0,0,0,1
962937,10/20 05:31 PM,F3XN,223,94,0,99,416
962936,10/20 05:30 PM,F3XN,0,2,0,0,2
962935,10/20 05:30 PM,F6N,6,0,0,0,6
962934,10/20 05:29 PM,F3XN,238,57,0,0,295
962933,10/20 05:29 PM,F3XN,24,0,0,0,24
962932,10/20 05:29 PM,F3XN,1,5,0,0,6
962931,10/20 05:28 PM,F3XN,1162,195,0,0,1357
962930,10/20 05:28 PM,F3XN,218,19,0,0,237
962929,10/20 05:28 PM,F3XN,190,11,0,0,201
962928,10/20 05:28 PM,F9N,0,0,0,3,3
962927,10/20 05:27 PM,F6N,3,0,0,0,3
962926,10/20 05:27 PM,F24N,0,0,1,0,1
962925,10/20 05:26 PM,F24N,0,0,1,0,1
962924,10/20 05:26 PM,F3XN,9,42,0,0,51
962923,10/20 05:24 PM,F3XN,0,2,0,0,2
962922,10/20 05:23 PM,F3XN,6,1,0,0,7
962921,10/20 05:23 PM,F3XN,179,0,0,1,180
962920,10/20 05:23 PM,F3XN,8,4,0,2,14
962919,10/20 05:22 PM,F3XN,41,3,0,0,44
962918,10/20 05:22 PM,F3XN,183,61,0,0,244
962917,10/20 05:22 PM,F3XN,28,2,0,0,30
962916,10/20 05:21 PM,F3XN,89,2,0,0,91
962915,10/20 05:21 PM,F3N,5,7,0,2,14
962914,10/20 05:21 PM,F6N,5,0,0,0,5
962913,10/20 05:20 PM,F3XN,32493,1267,0,45,33805
962912,10/20 05:20 PM,F3XN,486,17,0,1,504
962911,10/20 05:19 PM,F3XN,67,42,0,48,157
962910,10/20 05:19 PM,F6N,6,0,0,0,6
962909,10/20 05:19 PM,F24N,0,0,3,0,3
962908,10/20 05:19 PM,F3XN,0,1,0,0,1
962907,10/20 05:18 PM,F6N,4,0,0,0,4
962906,10/20 05:18 PM,F3XN,0,10,0,0,10
962905,10/20 05:18 PM,F3XN,62,1,0,0,63
962904,10/20 05:18 PM,F6N,1,0,0,0,1
962903,10/20 05:17 PM,F3XA,86,128,0,47,261
962902,10/20 05:17 PM,F3XN,73,33,0,1,107
962901,10/20 05:17 PM,F3XN,0,1,0,0,1
962900,10/20 05:16 PM,F3XN,0,0,0,1,1
962899,10/20 05:16 PM,F3XN,6,7,0,0,13
962898,10/20 05:15 PM,F1A,0,0,0,0,0
962897,10/20 05:14 PM,F6N,2,0,0,0,2
962896,10/20 05:13 PM,F3XN,26,1,0,0,27
962895,10/20 05:13 PM,F3XN,0,0,0,0,0
962894,10/20 05:11 PM,F3XN,107,47,0,1,155
962893,10/20 05:11 PM,F3XN,85,23,11,8,127
962892,10/20 05:11 PM,F3XN,26,25,0,0,51
962891,10/20 05:10 PM,F3XN,0,0,0,0,0
962890,10/20 05:10 PM,F99,0,0,0,0,0
962889,10/20 05:10 PM,F6N,6,0,0,0,6
962888,10/20 05:09 PM,F6N,1,0,0,0,1
962887,10/20 05:08 PM,F3XN,0,19,0,0,19
962886,10/20 05:08 PM,F3XN,45,192,0,84,321
962885,10/20 05:07 PM,F3XN,5,52,0,0,57
962884,10/20 05:07 PM,F3XN,64,23,0,0,87
962883,10/20 05:06 PM,F3XN,47,5,0,0,52
962882,10/20 05:06 PM,F3XN,0,119,0,0,119
962881,10/20 05:04 PM,F3XN,1600,135,0,1,1736
962880,10/20 05:03 PM,F3XN,39,3,11,0,53
962879,10/20 05:03 PM,F3XN,9,29,0,0,38
962878,10/20 05:03 PM,F6N,1,0,0,0,1
962877,10/20 05:02 PM,F24A,0,0,5,1,6
962876,10/20 05:01 PM,F6N,4,0,0,0,4
962875,10/20 05:01 PM,F3XN,11,16,0,0,27
962874,10/20 05:01 PM,F6N,4,0,0,0,4
962873,10/20 05:00 PM,F1A,0,0,0,0,0
962872,10/20 05:00 PM,F3XN,8,19,0,1,28
962871,10/20 05:00 PM,F3XN,0,4,0,0,4
962870,10/20 05:00 PM,F3XN,25,0,0,0,25
962869,10/20 04:59 PM,F3XN,0,1,0,0,1
962868,10/20 04:58 PM,F3XN,2,4,0,0,6
962867,10/20 04:58 PM,F3XN,18,28,0,10,56
962866,10/20 04:57 PM,F3XN,325,356,0,47,728
962865,10/20 04:57 PM,F3XN,0,21,0,0,21
962864,10/20 04:56 PM,F3XN,5,6,0,0,11
962863,10/20 04:56 PM,F3XN,0,1,0,0,1
962862,10/20 04:55 PM,F3XN,6,6,0,0,12
962861,10/20 04:55 PM,F6N,1,0,0,0,1
962860,10/20 04:53 PM,F1A,0,0,0,0,0
962859,10/20 04:53 PM,F3XN,554,71,0,0,625
962858,10/20 04:53 PM,F3XN,0,0,0,0,0
962857,10/20 04:53 PM,F6N,12,0,0,0,12
962856,10/20 04:53 PM,F3XN,1,3,0,0,4
962855,10/20 04:52 PM,F3XN,56,1,0,0,57
962854,10/20 04:52 PM,F3XN,21,7,0,0,28
962853,10/20 04:52 PM,F3XA,89,29,0,0,118
962852,10/20 04:51 PM,F3XN,23,26,0,0,49
962851,10/20 04:51 PM,F3XN,3,4,0,0,7
962850,10/20 04:51 PM,F6N,12,0,0,0,12
962849,10/20 04:50 PM,F6N,8,0,0,0,8
962848,10/20 04:50 PM,F3XN,3,3,0,0,6
962847,10/20 04:48 PM,F3XN,0,1,0,0,1
962846,10/20 04:48 PM,F3XN,0,1,0,0,1
962845,10/20 04:47 PM,F3XN,126,17,0,0,143
962844,10/20 04:47 PM,F3XN,104,0,0,0,104
962843,10/20 04:47 PM,F3XA,84,484,5,407,980
962842,10/20 04:47 PM,F3XN,23,20,0,0,43
962841,10/20 04:46 PM,F3XN,210,19,0,0,229
962840,10/20 04:46 PM,F3XN,0,0,0,0,0
962839,10/20 04:46 PM,F3XN,2,1,0,1,4
962838,10/20 04:45 PM,F3XN,4603,77,0,0,4680
962837,10/20 04:45 PM,F3XA,7,5,0,0,12
962836,10/20 04:45 PM,F3XN,5,2,0,0,7
962835,10/20 04:45 PM,F3XN,382,55,1,0,438
962834,10/20 04:43 PM,F3XN,171,20,0,1,192
962833,10/20 04:43 PM,F3XN,3,12,0,0,15
962832,10/20 04:43 PM,F6N,3,0,0,0,3
962831,10/20 04:43 PM,F3XN,1,1,0,0,2
962830,10/20 04:43 PM,F3XN,12,4,0,0,16
962829,10/20 04:43 PM,F3XN,0,4,0,0,4
962828,10/20 04:42 PM,F3XN,30,0,0,0,30
962827,10/20 04:42 PM,F3XN,132,93,0,37,262
962826,10/20 04:42 PM,F3XN,0,7,0,0,7
962825,10/20 04:42 PM,F24N,0,0,2,0,2
962824,10/20 04:41 PM,F3XN,6,13,0,0,19
962823,10/20 04:41 PM,F6N,5,0,0,0,5
962822,10/20 04:41 PM,F3N,2,2,0,4,8
962821,10/20 04:41 PM,F3XN,1083,121,0,0,1204
962820,10/20 04:40 PM,F3XN,14,2,0,0,16
962819,10/20 04:40 PM,F3XN,16,9,0,0,25
962818,10/20 04:40 PM,F6N,8,0,0,0,8
962817,10/20 04:40 PM,F3XN,1747,159,0,0,1906
962816,10/20 04:40 PM,F6N,2,0,0,0,2
962815,10/20 04:40 PM,F3XN,9,6,0,0,15
962814,10/20 04:39 PM,F3XN,110,3,0,0,113
962813,10/20 04:39 PM,F3A,45,47,0,3,95
962812,10/20 04:39 PM,F3XN,264,3,0,0,267
962811,10/20 04:38 PM,F3XN,14,0,0,0,14
962810,10/20 04:38 PM,F3XN,18,11,0,0,29
962809,10/20 04:37 PM,F3XN,0,9,0,0,9
962808,10/20 04:36 PM,F3XN,0,0,0,0,0
962807,10/20 04:36 PM,F3XN,24,52,0,0,76
962806,10/20 04:36 PM,F3XN,337,249,0,1,587
962805,10/20 04:35 PM,F3XN,80,1,0,0,81
962804,10/20 04:35 PM,F6N,3,0,0,2,5
962803,10/20 04:35 PM,F3XN,69,2,0,0,71
962802,10/20 04:34 PM,F3XN,3,14,0,0,17
962801,10/20 04:34 PM,F3XN,19,21,0,0,40
962800,10/20 04:34 PM,F3XN,133,20,47,18,218
962799,10/20 04:33 PM,F3XN,5,40,0,0,45
962798,10/20 04:33 PM,F24N,0,0,1,0,1
962797,10/20 04:32 PM,F3XN,14,1,0,0,15
962796,10/20 04:32 PM,F3XN,63,181,0,0,244
962795,10/20 04:32 PM,F3XN,11,0,0,0,11
962794,10/20 04:32 PM,F3XN,17,5,0,0,22
962793,10/20 04:31 PM,F3XN,2,0,0,0,2
962792,10/20 04:31 PM,F3XN,87,4,0,0,91
962791,10/20 04:31 PM,F6N,9,0,0,0,9
962790,10/20 04:31 PM,F3XN,0,0,0,0,0
962789,10/20 04:31 PM,F3XN,6,9,0,0,15
962788,10/20 04:31 PM,F3XN,764,115,0,0,879
962787,10/20 04:30 PM,F3XN,0,1,0,0,1
962786,10/20 04:30 PM,F3XN,0,0,0,0,0
962785,10/20 04:30 PM,F6N,6,0,0,0,6
962784,10/20 04:29 PM,F6N,2,0,0,0,2
962783,10/20 04:29 PM,F3XN,1,0,0,0,1
962782,10/20 04:29 PM,F3XN,410,89,0,140,639
962781,10/20 04:29 PM,F3XN,3,3,0,0,6
962780,10/20 04:29 PM,F3XN,0,0,0,0,0
962779,10/20 04:28 PM,F3XN,125,10,0,0,135
962778,10/20 04:27 PM,F6N,1,0,0,0,1
962777,10/20 04:27 PM,F3XN,54,31,0,0,85
962776,10/20 04:26 PM,F3XN,0,3,0,0,3
962775,10/20 04:26 PM,F5N,0,0,11,0,11
962774,10/20 04:26 PM,F3XN,0,1,0,0,1
962773,10/20 04:25 PM,F3XN,462,30,0,0,492
962772,10/20 04:24 PM,F3XN,0,1,0,0,1
962771,10/20 04:24 PM,F3XN,74,81,0,0,155
962770,10/20 04:24 PM,F3XN,13,2,0,0,15
962769,10/20 04:23 PM,F5N,0,0,2,0,2
962768,10/20 04:23 PM,F3XN,24,2,0,0,26
962767,10/20 04:23 PM,F3XN,0,1,0,0,1
962766,10/20 04:22 PM,F3XN,117,24,0,106,247
962765,10/20 04:22 PM,F6N,4,0,0,0,4
962764,10/20 04:22 PM,F3XN,140,3,0,0,143
962763,10/20 04:21 PM,F24A,0,0,5,0,5
962762,10/20 04:21 PM,F24N,0,0,1,0,1
962761,10/20 04:21 PM,F3XN,53,9,0,0,62
962760,10/20 04:21 PM,F3XN,120,27,0,0,147
962759,10/20 04:20 PM,F3XN,72,12,0,0,84
962758,10/20 04:19 PM,F3XN,73,91,0,0,164
962757,10/20 04:19 PM,F6N,1,0,0,0,1
962756,10/20 04:19 PM,F6N,3,0,0,0,3
962755,10/20 04:18 PM,F3XN,1558,115,0,0,1673
962754,10/20 04:18 PM,F3XN,219,37,0,0,256
962753,10/20 04:18 PM,F3XN,494,142,0,0,636
962752,10/20 04:18 PM,F6N,1,0,0,0,1
962751,10/20 04:17 PM,F3XN,2,3,0,0,5
962750,10/20 04:17 PM,F3XA,49,6,0,0,55
962749,10/20 04:17 PM,F3XN,2,0,0,0,2
962748,10/20 04:17 PM,F3XN,8,42,0,0,50
962747,10/20 04:16 PM,F6N,1,0,0,0,1
962746,10/20 04:15 PM,F3XN,8,0,0,0,8
962745,10/20 04:15 PM,F3XN,19,25,0,0,44
962744,10/20 04:14 PM,F3XA,1,0,0,1,2
962743,10/20 04:14 PM,F3XN,83,37,0,0,120
962742,10/20 04:14 PM,F3XN,71,118,51,26,266
962741,10/20 04:14 PM,F3XN,6,0,0,0,6
962740,10/20 04:13 PM,F3XN,0,2,0,0,2
962739,10/20 04:13 PM,F3XN,869,138,0,0,1007
962738,10/20 04:13 PM,F3XN,1,3,0,0,4
962737,10/20 04:13 PM,F3XN,0,8,0,0,8
962736,10/20 04:13 PM,F3XN,58,66,0,0,124
962735,10/20 04:13 PM,F3XN,34,21,0,0,55
962734,10/20 04:13 PM,F6N,3,0,0,0,3
962733,10/20 04:12 PM,F3XN,86,4,0,0,90
962732,10/20 04:12 PM,F3XN,142,11,0,0,153
962731,10/20 04:12 PM,F24N,0,0,1,0,1
962730,10/20 04:12 PM,F6N,2,0,0,0,2
962729,10/20 04:11 PM,F3XN,72,5,0,0,77
962728,10/20 04:11 PM,F3XN,112,42,0,0,154
962727,10/20 04:11 PM,F3XN,243,48,0,0,291
962726,10/20 04:11 PM,F3XA,0,4,0,1,5
962725,10/20 04:11 PM,F3XN,19,0,0,0,19
962724,10/20 04:11 PM,F3XN,0,0,0,0,0
962723,10/20 04:09 PM,F3XA,6,2,0,1,9
962722,10/20 04:09 PM,F3XN,65,1,0,0,66
962721,10/20 04:08 PM,F3XN,65,3,0,0,68
962720,10/20 04:08 PM,F6N,1,0,0,0,1
962719,10/20 04:08 PM,F3XN,113,22,0,0,135
962718,10/20 04:07 PM,F3XN,547,64,0,0,611
962717,10/20 04:07 PM,F3XN,237,22,0,0,259
962716,10/20 04:07 PM,F3XN,6,11,0,0,17
962715,10/20 04:07 PM,F6N,8,0,0,0,8
962714,10/20 04:06 PM,F3XN,80,1,0,0,81
962713,10/20 04:06 PM,F6N,4,0,0,0,4
962712,10/20 04:06 PM,F3XN,0,4,0,1,5
962711,10/20 04:06 PM,F3XN,22,0,0,0,22
962710,10/20 04:05 PM,F3XN,3,1,0,0,4
962709,10/20 04:05 PM,F3XN,12,46,0,0,58
962708,10/20 04:05 PM,F3A,235,74,0,9,318
962707,10/20 04:05 PM,F3XN,236,114,0,0,350
962706,10/20 04:04 PM,F24A,0,0,3,0,3
962705,10/20 04:03 PM,F3XN,19,7,0,0,26
962704,10/20 04:03 PM,F6N,1,0,0,0,1
962703,10/20 04:03 PM,F6N,1,0,0,0,1
962702,10/20 04:02 PM,F3XN,16,1,0,2,19
962701,10/20 04:02 PM,F3XN,34,28,0,0,62
962700,10/20 04:02 PM,F3XN,17,42,0,0,59
962699,10/20 04:02 PM,F6N,1,0,0,0,1
962698,10/20 04:02 PM,F6N,1,0,0,0,1
962697,10/20 04:01 PM,F3XN,275,144,0,188,607
962696,10/20 04:01 PM,F3XN,1,1,0,0,2
962695,10/20 04:00 PM,F3XN,32,66,0,0,98
962694,10/20 04:00 PM,F3XN,15,0,0,4,19
962693,10/20 03:59 PM,F6N,2,0,0,0,2
962692,10/20 03:59 PM,F3XN,45,0,0,0,45
962691,10/20 03:59 PM,F3XN,567,103,0,0,670
962690,10/20 03:59 PM,F3XN,90,7,0,0,97
962689,10/20 03:58 PM,F3XN,34,2,0,2,38
962688,10/20 03:57 PM,F3XN,2,4,0,0,6
962687,10/20 03:57 PM,F3XN,54,20,0,9,83
962686,10/20 03:57 PM,F6N,2,0,0,0,2
962685,10/20 03:57 PM,F3XN,3,15,0,0,18
962684,10/20 03:56 PM,F3XN,31,10,0,69,110
962683,10/20 03:55 PM,F3XN,0,3,0,0,3
962682,10/20 03:55 PM,F3XN,110,101,0,0,211
962681,10/20 03:54 PM,F6N,2,0,0,0,2
962680,10/20 03:54 PM,F6N,2,0,0,0,2
962679,10/20 03:53 PM,F3XN,1,7,0,3,11
962678,10/20 03:53 PM,F3XN,3,1,0,0,4
962677,10/20 03:52 PM,F3A,14,39,0,1,54
962676,10/20 03:51 PM,F3XN,3,36,0,0,39
962675,10/20 03:50 PM,F99,0,0,0,0,0
962674,10/20 03:49 PM,F3XN,1832,198,1,1,2032
962673,10/20 03:48 PM,F3XN,34,10,0,65,109
962672,10/20 03:48 PM,F3XN,1,0,0,1,2
962671,10/20 03:48 PM,F3XN,0,0,0,0,0
962670,10/20 03:47 PM,F6N,2,0,0,0,2
962669,10/20 03:47 PM,F3XN,0,0,0,0,0
962668,10/20 03:47 PM,F3XN,2,0,0,0,2
962667,10/20 03:46 PM,F3XN,1,1,0,1,3
962666,10/20 03:45 PM,F1A,0,0,0,0,0
962665,10/20 03:45 PM,F3XN,214,54,0,317,585
962664,10/20 03:45 PM,F3XN,3,3,0,0,6
962663,10/20 03:44 PM,F3XN,11,0,0,0,11
962662,10/20 03:43 PM,F3XN,0,0,0,0,0
962661,10/20 03:42 PM,F3XN,0,1,0,0,1
962660,10/20 03:42 PM,F99,0,0,0,0,0
962659,10/20 03:42 PM,F6N,2,0,0,0,2
962658,10/20 03:42 PM,F3XN,2,0,0,0,2
962657,10/20 03:41 PM,F3XN,30,33,0,0,63
962656,10/20 03:40 PM,F6N,4,0,0,0,4
962655,10/20 03:40 PM,F3XN,0,3,0,0,3
962654,10/20 03:40 PM,F3XN,424,51,0,1,476
962653,10/20 03:39 PM,F3XN,0,1,0,0,1
962652,10/20 03:38 PM,F3XN,1073,97,4,1,1175
962651,10/20 03:36 PM,F3XN,0,0,0,0,0
962650,10/20 03:35 PM,F6N,1,0,0,0,1
962649,10/20 03:35 PM,F3XN,101,14,0,0,115
962648,10/20 03:35 PM,F3XA,16,1,0,0,17
962647,10/20 03:34 PM,F6N,4,0,0,0,4
962646,10/20 03:33 PM,F3XN,0,5,0,0,5
962645,10/20 03:33 PM,F3XN,159,4,0,0,163
962644,10/20 03:33 PM,F6N,1,0,0,0,1
962643,10/20 03:32 PM,F3XN,1168,138,0,0,1306
962642,10/20 03:31 PM,F3XN,231,73,12,20,336
962641,10/20 03:31 PM,F99,0,0,0,0,0
962640,10/20 03:31 PM,F3XN,5,3,0,0,8
962639,10/20 03:31 PM,F3XN,2,2,0,0,4
962638,10/20 03:30 PM,F24N,0,0,1,0,1
962637,10/20 03:30 PM,F3XN,285,493,3,7,788
962636,10/20 03:30 PM,F3XN,94,161,0,123,378
962635,10/20 03:28 PM,F3XN,1,0,0,0,1
962634,10/20 03:28 PM,F3XN,41,0,0,0,41
962633,10/20 03:28 PM,F3XN,11,0,0,0,11
962632,10/20 03:28 PM,F3XN,128,70,0,61,259
962631,10/20 03:27 PM,F3XN,0,0,0,0,0
962630,10/20 03:26 PM,F3XN,0,0,0,0,0
962629,10/20 03:25 PM,F3XN,1600,124,0,1,1725
962628,10/20 03:25 PM,F3XN,0,0,0,2,2
962627,10/20 03:25 PM,F3XN,0,3,0,1,4
962626,10/20 03:24 PM,F3XN,9,2,0,34,45
962625,10/20 03:23 PM,F3XN,5692,159,0,1,5852
962624,10/20 03:23 PM,F3XN,0,0,0,0,0
962623,10/20 03:22 PM,F3XN,182,48,0,1,231
962622,10/20 03:22 PM,F3XN,5,11,0,1,17
962621,10/20 03:22 PM,F3XN,31,43,0,0,74
962620,10/20 03:22 PM,F3XN,45,63,0,121,229
962619,10/20 03:21 PM,F3XN,138,17,0,0,155
962618,10/20 03:20 PM,F3XN,24,40,0,0,64
962617,10/20 03:20 PM,F6N,3,0,0,0,3
962616,10/20 03:19 PM,F3XA,24,1,0,0,25
962615,10/20 03:18 PM,F3XN,439,72,0,0,511
962614,10/20 03:18 PM,F3XN,31,1,0,0,32
962613,10/20 03:17 PM,F3XA,5455,85,0,3,5543
962612,10/20 03:17 PM,F3XN,24,12,0,0,36
962611,10/20 03:17 PM,F6N,4,0,0,0,4
962610,10/20 03:17 PM,F3XN,0,0,0,0,0
962609,10/20 03:16 PM,F1N,0,0,0,0,0
962608,10/20 03:16 PM,F3XN,0,2,0,0,2
962607,10/20 03:15 PM,F3XN,6,15,0,0,21
962606,10/20 03:15 PM,F3XN,3,0,0,0,3
962605,10/20 03:14 PM,F99,0,0,0,0,0
962604,10/20 03:13 PM,F3XN,2373,2314,0,0,4687
962603,10/20 03:13 PM,F3XN,6,6,0,0,12
962602,10/20 03:13 PM,F6N,2,0,0,0,2
962601,10/20 03:12 PM,F3XN,58,21,0,1,80
962600,10/20 03:12 PM,F1A,0,0,0,0,0
962599,10/20 03:12 PM,F3XN,225,15,0,157,397
962598,10/20 03:12 PM,F3XA,46,77,0,35,158
962597,10/20 03:12 PM,F3XN,2,0,0,0,2
962596,10/20 03:11 PM,F3XN,718,13,0,1,732
962595,10/20 03:10 PM,F3XN,0,15,0,0,15
962594,10/20 03:08 PM,F3XN,1,2,0,12,15
962593,10/20 03:07 PM,F3XN,1701,153,0,2,1856
962592,10/20 03:07 PM,F3A,290,210,0,0,500
962591,10/20 03:06 PM,F3XN,0,0,0,0,0
962590,10/20 03:06 PM,F3XN,75,39,0,0,114
962589,10/20 03:06 PM,F3XA,628,598,0,0,1226
962588,10/20 03:05 PM,F6A,5,0,0,0,5
962587,10/20 03:05 PM,F3N,14,33,0,0,47
962586,10/20 03:04 PM,F3XN,311,0,0,0,311
962585,10/20 03:03 PM,F3XN,1137,180,0,0,1317
962584,10/20 03:03 PM,F3XN,111,17,0,0,128
962583,10/20 03:02 PM,F3XN,226,12,0,0,238
962582,10/20 03:02 PM,F3N,14,16,0,1,31
962581,10/20 03:01 PM,F3XN,5,1,0,0,6
962580,10/20 03:01 PM,F3XN,41,39,0,1,81
962579,10/20 03:01 PM,F3XN,2,4,0,0,6
962578,10/20 03:00 PM,F3XN,0,2,0,0,2
962577,10/20 03:00 PM,F6N,1,0,0,0,1
962576,10/20 03:00 PM,F3XN,0,0,0,0,0
962575,10/20 02:59 PM,F3N,0,1,0,0,1
962574,10/20 02:58 PM,F3XN,10,1,0,0,11
962573,10/20 02:58 PM,F3A,104,124,0,2,230
962572,10/20 02:58 PM,F3XN,0,3,0,0,3
962571,10/20 02:56 PM,F3XN,0,0,0,0,0
962570,10/20 02:55 PM,F3XN,43,3,0,0,46
962569,10/20 02:55 PM,F3XN,326,245,0,171,742
962568,10/20 02:55 PM,F3XN,0,1,0,0,1
962567,10/20 02:54 PM,F3XN,0,0,0,0,0
962566,10/20 02:53 PM,F3XN,0,0,0,0,0
962565,10/20 02:53 PM,F3XN,27,17,0,7,51
962564,10/20 02:52 PM,F3XN,0,5,0,0,5
962563,10/20 02:52 PM,F3XA,182,15,0,110,307
962562,10/20 02:52 PM,F6N,2,0,0,0,2
962561,10/20 02:51 PM,F3XN,0,1,0,0,1
962560,10/20 02:51 PM,F3XN,0,2,3,0,5
962559,10/20 02:51 PM,F3XN,113,115,0,292,520
962558,10/20 02:51 PM,F3XN,0,3,0,0,3
962557,10/20 02:50 PM,F3XN,2,3,0,0,5
962556,10/20 02:50 PM,F3XN,0,2,0,0,2
962555,10/20 02:49 PM,F3N,20,64,0,0,84
962554,10/20 02:49 PM,F3XN,215,47,0,0,262
962553,10/20 02:48 PM,F6N,5,0,0,0,5
962552,10/20 02:48 PM,F3XN,0,0,0,0,0
962551,10/20 02:47 PM,F3XN,0,1,0,0,1
962550,10/20 02:47 PM,F3A,104,124,0,2,230
962549,10/20 02:47 PM,F3XN,0,3,0,0,3
962548,10/20 02:47 PM,F3XN,0,3,0,0,3
962547,10/20 02:47 PM,F3XN,64,7,0,0,71
962546,10/20 02:47 PM,F3XN,33,6,0,2,41
962545,10/20 02:46 PM,F24N,0,0,6,0,6
962544,10/20 02:46 PM,F3XN,0,1,0,0,1
962543,10/20 02:46 PM,F3XN,28,5,0,2,35
962542,10/20 02:45 PM,F3XN,63,27,0,0,90
962541,10/20 02:45 PM,F3XN,41,3,0,0,44
962540,10/20 02:44 PM,F3XN,17,150,0,0,167
962539,10/20 02:44 PM,F3XN,2,2,0,0,4
962538,10/20 02:43 PM,F3XN,767,46,0,0,813
962537,10/20 02:43 PM,F3XN,66,10,0,2,78
962536,10/20 02:43 PM,F3XN,1,11,0,0,12
962535,10/20 02:43 PM,F3XA,0,1,0,0,1
962534,10/20 02:43 PM,F3XN,0,35,0,0,35
962533,10/20 02:42 PM,F3XN,102,668,0,1,771
962532,10/20 02:41 PM,F3XN,15,9,0,44,68
962531,10/20 02:41 PM,F3XN,20,25,0,0,45
962530,10/20 02:41 PM,F3XN,18,0,0,0,18
962529,10/20 02:41 PM,F3XN,35,0,0,0,35
962528,10/20 02:41 PM,F3XN,138,9,0,0,147
962527,10/20 02:39 PM,F3PN,0,0,0,0,0
962526,10/20 02:39 PM,F6N,3,0,0,0,3
962525,10/20 02:37 PM,F6N,19,0,0,0,19
962524,10/20 02:37 PM,F3XN,136,38,0,0,174
962523,10/20 02:37 PM,F3XA,1,1,0,0,2
962522,10/20 02:36 PM,F3XN,0,45,0,0,45
962521,10/20 02:36 PM,F3XN,5,0,0,0,5
962520,10/20 02:35 PM,F3XN,0,2,0,2,4
962519,10/20 02:35 PM,F3XN,14,7,0,0,21
962518,10/20 02:35 PM,F6N,3,0,0,0,3
962517,10/20 02:34 PM,F3XA,184,23,0,105,312
962516,10/20 02:34 PM,F3XN,9,15,0,0,24
962515,10/20 02:33 PM,F3XN,0,4,0,0,4
962514,10/20 02:33 PM,F3XN,9,3,0,0,12
962513,10/20 02:32 PM,F3XN,24,1,0,0,25
962512,10/20 02:32 PM,F3XN,10,21,0,0,31
962511,10/20 02:30 PM,F3XN,14,4,0,0,18
962510,10/20 02:30 PM,F99,0,0,0,0,0
962509,10/20 02:30 PM,F3XN,60,5,0,0,65
962508,10/20 02:29 PM,F3XN,0,2,0,0,2
962507,10/20 02:28 PM,F3XN,15,13,0,0,28
962506,10/20 02:28 PM,F3XA,510,90,0,1,601
962505,10/20 02:28 PM,F3XN,14,13,0,0,27
962504,10/20 02:28 PM,F3XN,30,0,0,0,30
962503,10/20 02:27 PM,F3XN,0,0,0,0,0
962502,10/20 02:27 PM,F3XA,0,2,0,2,4
962501,10/20 02:27 PM,F3XN,17,2,0,0,19
962500,10/20 02:27 PM,F3XN,0,8,0,0,8
962499,10/20 02:26 PM,F3XN,39,71,0,0,110
962498,10/20 02:26 PM,F3XN,0,0,0,0,0
962497,10/20 02:26 PM,F6N,2,0,0,0,2
962496,10/20 02:26 PM,F3XN,7,17,0,0,24
962495,10/20 02:25 PM,F3N,30,11,0,0,41
962494,10/20 02:25 PM,F3XN,0,8,0,4,12
962493,10/20 02:25 PM,F3XN,2,0,0,0,2
962492,10/20 02:24 PM,F3XN,44,0,0,0,44
962491,10/20 02:23 PM,F3XN,524,318,0,173,1015
962490,10/20 02:23 PM,F6N,1,0,0,0,1
962489,10/20 02:23 PM,F3XN,750,2,0,1,753
962488,10/20 02:23 PM,F3XN,0,0,0,0,0
962487,10/20 02:23 PM,F3XN,0,0,0,7,7
962486,10/20 02:21 PM,F3N,0,0,0,22,22
962485,10/20 02:21 PM,F3XN,0,0,0,0,0
962484,10/20 02:21 PM,F3XN,13,13,0,0,26
962483,10/20 02:20 PM,F3XN,92,24,0,0,116
962482,10/20 02:19 PM,F3XN,31,13,0,258,302
962481,10/20 02:19 PM,F3XN,0,0,0,0,0
962480,10/20 02:19 PM,F3XN,13,1,0,0,14
962479,10/20 02:19 PM,F3XA,1,4,0,6,11
962478,10/20 02:17 PM,F3XN,191,10,0,0,201
962477,10/20 02:17 PM,F3XA,233,29,0,67,329
962476,10/20 02:15 PM,F3XN,13,5,0,2,20
962475,10/20 02:14 PM,F6N,1,0,0,0,1
962474,10/20 02:14 PM,F3XN,2,5,0,0,7
962473,10/20 02:14 PM,F3XN,88,7,0,0,95
962472,10/20 02:14 PM,F3XN,59,7,0,0,66
962471,10/20 02:13 PM,F3XN,22,20,0,0,42
962470,10/20 02:13 PM,F3XN,3,2,0,0,5
962469,10/20 02:09 PM,F3XN,0,1,0,0,1
962468,10/20 02:09 PM,F3XN,171552,3915,307,6,175780
962467,10/20 02:07 PM,F3XN,0,0,0,0,0
962466,10/20 02:07 PM,F3XN,1,3,0,0,4
962465,10/20 02:06 PM,F5N,0,0,114,0,114
962464,10/20 02:06 PM,F3XN,54,7,0,0,61
962463,10/20 02:06 PM,F3XN,3,6,0,0,9
962462,10/20 02:05 PM,F3XN,667,29,0,0,696
962461,10/20 02:04 PM,F3XN,0,0,0,0,0
962460,10/20 02:04 PM,F3XA,136,23,0,57,216
962459,10/20 02:03 PM,F3XN,224,64,0,0,288
962458,10/20 02:03 PM,F3XN,22,21,0,1,44
962457,10/20 02:03 PM,F3XN,2,3,0,0,5
962456,10/20 02:02 PM,F3XN,187,143,0,0,330
962455,10/20 02:02 PM,F6N,1,0,0,0,1
962454,10/20 02:02 PM,F24N,0,0,1,0,1
962453,10/20 02:02 PM,F3XN,18,5,0,0,23
962452,10/20 02:00 PM,F3XN,0,0,0,0,0
962451,10/20 01:59 PM,F6N,6,0,0,0,6
962450,10/20 01:59 PM,F3XN,10,12,0,0,22
962449,10/20 01:58 PM,F6N,1,0,0,0,1
962448,10/20 01:58 PM,F6N,3,0,0,0,3
962447,10/20 01:57 PM,F3XN,199,11,0,0,210
962446,10/20 01:56 PM,F6N,2,0,0,0,2
962445,10/20 01:56 PM,F3XA,1,4,0,3,8
962444,10/20 01:56 PM,F3XA,22,25,0,0,47
962443,10/20 01:56 PM,F3XN,165,202,0,255,622
962442,10/20 01:55 PM,F3XN,0,8,0,0,8
962441,10/20 01:55 PM,F3XN,2,0,0,0,2
962440,10/20 01:55 PM,F3XN,3,1,0,0,4
962439,10/20 01:55 PM,F3XN,6,3,1,2,12
962438,10/20 01:53 PM,F3XN,66,8,0,7,81
962437,10/20 01:53 PM,F3XN,2,0,0,0,2
962436,10/20 01:52 PM,F3XA,102,21,0,81,204
962435,10/20 01:52 PM,F3XN,6,23,0,0,29
962434,10/20 01:51 PM,F3XN,0,12,0,0,12
962433,10/20 01:51 PM,F3XN,56,6,0,91,153
962432,10/20 01:51 PM,F3XN,549,55,0,0,604
962431,10/20 01:50 PM,F3XN,0,1,5,0,6
962430,10/20 01:50 PM,F3XN,15,17,0,2,34
962429,10/20 01:50 PM,F3XN,4,4,0,3,11
962428,10/20 01:49 PM,F3XN,160,12,0,0,172
962427,10/20 01:48 PM,F6N,8,0,0,0,8
962426,10/20 01:48 PM,F5N,0,0,1,0,1
962425,10/20 01:48 PM,F3XN,0,44,0,0,44
962424,10/20 01:47 PM,F3XN,212,43,0,1,256
962423,10/20 01:47 PM,F6N,2,0,0,0,2
962422,10/20 01:47 PM,F6N,4,0,0,0,4
962421,10/20 01:47 PM,F5N,0,0,1,0,1
962420,10/20 01:47 PM,F6N,1,0,0,0,1
962419,10/20 01:46 PM,F3XN,1,1,0,0,2
962418,10/20 01:46 PM,F3XN,19,0,0,0,19
962417,10/20 01:46 PM,F24N,0,0,3,0,3
962416,10/20 01:45 PM,F3XN,11,6,0,0,17
962415,10/20 01:45 PM,F3XN,254,29,0,0,283
962414,10/20 01:44 PM,F3XN,450,58,0,0,508
962413,10/20 01:44 PM,F3XN,54,20,0,0,74
962412,10/20 01:44 PM,F24N,0,0,1,0,1
962411,10/20 01:43 PM,F3XN,52,1,0,0,53
962410,10/20 01:42 PM,F99,0,0,0,0,0
962409,10/20 01:42 PM,F3XN,1,70,0,0,71
962408,10/20 01:42 PM,F3XN,0,3,0,0,3
962407,10/20 01:41 PM,F3XA,249,7,0,0,256
962406,10/20 01:41 PM,F6N,3,0,0,0,3
962405,10/20 01:41 PM,F3XN,30,0,0,0,30
962404,10/20 01:40 PM,F3XN,4,8,0,0,12
962403,10/20 01:40 PM,F3XN,21,1,0,0,22
962402,10/20 01:40 PM,F3XN,277,49,0,1,327
962401,10/20 01:39 PM,F3XN,0,3,0,0,3
962400,10/20 01:39 PM,F3XA,26,21,0,1,48
962399,10/20 01:39 PM,F3XN,0,2,0,0,2
962398,10/20 01:38 PM,F3XN,78,23,0,0,101
962397,10/20 01:38 PM,F3XN,7,9,0,2,18
962396,10/20 01:38 PM,F3XN,56,289,0,0,345
962395,10/20 01:38 PM,F3XN,8,4,0,0,12
962394,10/20 01:37 PM,F3XN,0,0,0,0,0
962393,10/20 01:37 PM,F3XN,34,82,0,0,116
962392,10/20 01:36 PM,F6N,22,0,0,0,22
962391,10/20 01:36 PM,F3XA,8,12,0,0,20
962390,10/20 01:35 PM,F3N,0,3,0,0,3
962389,10/20 01:35 PM,F24N,0,0,3,0,3
962388,10/20 01:33 PM,F3XN,5,1,0,0,6
962387,10/20 01:32 PM,F3XN,77,43,0,0,120
962386,10/20 01:31 PM,F3XN,1,0,0,0,1
962385,10/20 01:31 PM,F3XA,53,12,0,5,70
962384,10/20 01:31 PM,F3XN,10,0,0,0,10
962383,10/20 01:27 PM,F3XN,649,422,0,0,1071
962382,10/20 01:27 PM,F3XA,255,54,0,56,365
962381,10/20 01:27 PM,F3N,0,0,0,0,0
962380,10/20 01:27 PM,F3XN,521,39,0,0,560
962379,10/20 01:26 PM,F3XN,0,1,0,0,1
962378,10/20 01:25 PM,F3XN,291,33,0,0,324
962377,10/20 01:24 PM,F3XN,34,2,0,0,36
962376,10/20 01:23 PM,F3XN,0,3,0,1,4
962375,10/20 01:22 PM,F6N,4,0,0,0,4
962374,10/20 01:22 PM,F3XN,84,3,0,0,87
962373,10/20 01:22 PM,F3XN,182,147,0,28,357
962372,10/20 01:22 PM,F3XN,160,5,0,0,165
962371,10/20 01:21 PM,F3XN,0,4,0,0,4
962370,10/20 01:21 PM,F3XN,592,117,0,0,709
962369,10/20 01:21 PM,F3XN,3,1,0,0,4
962368,10/20 01:20 PM,F3N,13,39,0,0,52
962367,10/20 01:18 PM,F3XN,6,30,0,1,37
962366,10/20 01:18 PM,F6N,1,0,0,0,1
962365,10/20 01:18 PM,F3XN,50,14,0,0,64
962364,10/20 01:17 PM,F3XN,395,22,0,0,417
962363,10/20 01:17 PM,F3XN,12,0,0,0,12
962362,10/20 01:16 PM,F3XN,46,28,0,0,74
962361,10/20 01:16 PM,F3XN,612,51,0,0,663
962360,10/20 01:16 PM,F3XN,36,1,0,0,37
962359,10/20 01:16 PM,F3XN,232,1,0,0,233
962358,10/20 01:15 PM,F3XN,0,3,0,0,3
962357,10/20 01:15 PM,F3XN,0,0,0,0,0
962356,10/20 01:14 PM,F3XN,0,4,0,0,4
962355,10/20 01:13 PM,F3XN,366,59,0,0,425
962354,10/20 01:13 PM,F3XN,2,11,0,8,21
962353,10/20 01:12 PM,F3XN,8,1,0,0,9
962352,10/20 01:12 PM,F3XN,12,12,0,0,24
962351,10/20 01:12 PM,F6A,4,0,0,0,4
962350,10/20 01:11 PM,F3XN,11,2,0,0,13
962349,10/20 01:11 PM,F3XN,0,0,0,0,0
962348,10/20 01:10 PM,F3XN,58,4,0,0,62
962347,10/20 01:10 PM,F3XN,0,1,0,0,1
962346,10/20 01:09 PM,F3XN,6,8,0,0,14
962345,10/20 01:08 PM,F3XN,0,0,0,0,0
962344,10/20 01:08 PM,F3XN,0,0,0,0,0
962343,10/20 01:08 PM,F24N,0,0,2,0,2
962342,10/20 01:08 PM,F6N,3,0,0,0,3
962341,10/20 01:03 PM,F3XN,4,12,0,0,16
962340,10/20 01:02 PM,F3XN,15,172,4114,0,4301
962339,10/20 01:02 PM,F3XN,11,0,0,0,11
962338,10/20 01:02 PM,F6N,1,0,0,0,1
962337,10/20 01:02 PM,F3XN,186,23,0,0,209
962336,10/20 01:01 PM,F3XN,6,3,0,0,9
962335,10/20 01:01 PM,F3XN,0,1,0,0,1
962334,10/20 12:59 PM,F6N,3,0,0,0,3
962333,10/20 12:59 PM,F6N,1,0,0,0,1
962332,10/20 12:59 PM,F3A,556,268,0,21,845
962331,10/20 12:58 PM,F6N,1,0,0,0,1
962330,10/20 12:58 PM,F3XN,98,66,0,0,164
962329,10/20 12:58 PM,F3XN,5,9,0,0,14
962328,10/20 12:58 PM,F3XN,168,40,0,1,209
962327,10/20 12:57 PM,F3XN,0,0,10,0,10
962326,10/20 12:57 PM,F3XN,0,0,0,0,0
962325,10/20 12:57 PM,F6N,2,0,0,0,2
962324,10/20 12:56 PM,F3XN,0,2,0,1,3
962323,10/20 12:56 PM,F3XN,18,18,0,0,36
962322,10/20 12:55 PM,F24N,0,0,1,0,1
962321,10/20 12:54 PM,F6N,1,0,0,0,1
962320,10/20 12:53 PM,F3XN,3,5,0,0,8
962319,10/20 12:53 PM,F3XN,11,1,0,0,12
962318,10/20 12:52 PM,F3XN,88,15,0,0,103
962317,10/20 12:52 PM,F6N,2,0,0,0,2
962316,10/20 12:52 PM,F6N,4,0,0,0,4
962315,10/20 12:48 PM,F6N,4,0,0,0,4
962314,10/20 12:47 PM,F6N,2,0,0,0,2
962313,10/20 12:47 PM,F3XN,7,11,0,0,18
962312,10/20 12:46 PM,F3XN,0,2,0,0,2
962311,10/20 12:45 PM,F6N,4,0,0,0,4
962310,10/20 12:43 PM,F3XN,160,19,0,0,179
962309,10/20 12:43 PM,F3XN,1041,218,0,0,1259
962308,10/20 12:40 PM,F3XN,58,47,0,47,152
962307,10/20 12:40 PM,F6N,9,0,0,0,9
962306,10/20 12:39 PM,F3XN,31,10,0,0,41
962305,10/20 12:39 PM,F3XN,1,0,0,0,1
962304,10/20 12:37 PM,F3XN,0,0,0,0,0
962303,10/20 12:34 PM,F3XN,0,7,0,0,7
962302,10/20 12:33 PM,F6N,2,0,0,0,2
962301,10/20 12:32 PM,F3XN,18,16,0,0,34
962300,10/20 12:30 PM,F3XN,21,0,0,19,40
962299,10/20 12:30 PM,F3XN,29,13,0,0,42
962298,10/20 12:29 PM,F3XN,140,32,0,268,440
962297,10/20 12:29 PM,F6N,1,0,0,0,1
962296,10/20 12:29 PM,F3XN,2,6,0,0,8
962295,10/20 12:24 PM,F3XN,392,18,0,0,410
962294,10/20 12:22 PM,F3XN,425,21,0,0,446
962293,10/20 12:22 PM,F3XN,13,3,0,0,16
962292,10/20 12:21 PM,F3XN,2,1,2,0,5
962291,10/20 12:21 PM,F3XN,29,3,0,58,90
962290,10/20 12:19 PM,F3XN,137,78,0,0,215
962289,10/20 12:19 PM,F3XN,131,18,0,0,149
962288,10/20 12:17 PM,F3XN,0,0,0,0,0
962287,10/20 12:16 PM,F3XN,0,0,0,0,0
962286,10/20 12:15 PM,F3XN,15,10,0,0,25
962285,10/20 12:11 PM,F3XN,1,0,0,0,1
962284,10/20 12:11 PM,F3XA,0,0,0,0,0
962283,10/20 12:10 PM,F3XN,154,99,0,0,253
962282,10/20 12:10 PM,F3XN,14,24,0,0,38
962281,10/20 12:08 PM,F3XN,108,53,1,0,162
962280,10/20 12:07 PM,F3XN,0,1,0,0,1
962279,10/20 12:06 PM,F3XN,1228,18,0,0,1246
962278,10/20 12:05 PM,F3XN,150,27,0,158,335
962277,10/20 12:04 PM,F3XN,0,3,0,0,3
962276,10/20 12:04 PM,F3XN,112,7,0,0,119
962275,10/20 12:04 PM,F3XN,0,0,0,0,0
962274,10/20 12:04 PM,F3XN,52,26,0,117,195
962273,10/20 12:03 PM,F3N,0,1,0,1,2
962272,10/20 12:01 PM,F3XN,4,3,0,0,7
962271,10/20 12:00 PM,F3XN,0,12,0,0,12
962270,10/20 12:00 PM,F3XN,8,19,0,0,27
962269,10/20 12:00 PM,F3XN,0,1,0,0,1
962268,10/20 12:00 PM,F3XN,86,6,0,0,92
962267,10/20 11:59 AM,F3XN,0,0,0,0,0
962266,10/20 11:59 AM,F3XN,61,0,0,0,61
962265,10/20 11:59 AM,F3XN,0,0,0,0,0
962264,10/20 11:58 AM,F3XN,5,9,0,0,14
962263,10/20 11:58 AM,F3XN,101,15,0,0,116
962262,10/20 11:57 AM,F3XN,29,1,0,0,30
962261,10/20 11:57 AM,F3XN,181,30,0,0,211
962260,10/20 11:56 AM,F3XN,23,8,0,0,31
962259,10/20 11:55 AM,F3XN,25,61,57,16,159
962258,10/20 11:53 AM,F3XN,277,8,0,0,285
962257,10/20 11:52 AM,F3XN,115,261,0,0,376
962256,10/20 11:52 AM,F3A,127,171,0,3,301
962255,10/20 11:51 AM,F3XN,76,47,0,0,123
962254,10/20 11:50 AM,F3XN,39,4,0,0,43
962253,10/20 11:49 AM,F3XN,18,4,0,0,22
962252,10/20 11:48 AM,F3XN,7,1,0,37,45
962251,10/20 11:48 AM,F3XN,301,15,0,0,316
962250,10/20 11:45 AM,F3XN,5,0,0,33,38
962249,10/20 11:44 AM,F3XN,4,3,0,0,7
962248,10/20 11:44 AM,F3XN,85,4,0,0,89
962247,10/20 11:43 AM,F3XN,2744,122,0,143,3009
962246,10/20 11:42 AM,F6N,1,0,0,0,1
962245,10/20 11:42 AM,F3XN,0,1,0,0,1
962244,10/20 11:41 AM,F3XN,17,20,0,0,37
962243,10/20 11:40 AM,F3XN,0,0,0,0,0
962242,10/20 11:38 AM,F3XN,9,36,0,0,45
962241,10/20 11:38 AM,F3XN,54,1,0,0,55
962240,10/20 11:37 AM,F3XN,0,1,0,0,1
962239,10/20 11:37 AM,F3XN,2720,257,0,0,2977
962238,10/20 11:37 AM,F3XN,62,41,0,0,103
962237,10/20 11:36 AM,F3XN,13,27,0,0,40
962236,10/20 11:34 AM,F3N,0,4,0,1,5
962235,10/20 11:33 AM,F3XN,73,7,0,0,80
962234,10/20 11:33 AM,F3XN,4,5,0,0,9
962233,10/20 11:32 AM,F3XN,27,43,0,0,70
962232,10/20 11:30 AM,F3XN,16,5,0,0,21
962231,10/20 11:30 AM,F3XN,2,4,0,0,6
962230,10/20 11:29 AM,F3XN,0,0,0,0,0
962229,10/20 11:28 AM,F6N,3,0,0,0,3
962228,10/20 11:27 AM,F3XN,0,0,0,0,0
962227,10/20 11:27 AM,F3XN,5,2,0,0,7
962226,10/20 11:27 AM,F3XN,138,149,0,0,287
962225,10/20 11:26 AM,F3XN,301,30,0,0,331
962224,10/20 11:26 AM,F3XN,122,3,0,0,125
962223,10/20 11:25 AM,F3XN,7,0,0,0,7
962222,10/20 11:25 AM,F3XN,19,2,0,0,21
962221,10/20 11:24 AM,F3XN,1,0,0,0,1
962220,10/20 11:23 AM,F3XN,0,0,0,0,0
962219,10/20 11:23 AM,F3XN,30,0,0,0,30
962218,10/20 11:22 AM,F3XN,13,9,0,0,22
962217,10/20 11:21 AM,F3XN,19,4,0,0,23
962216,10/20 11:21 AM,F3XN,6,11,0,0,17
962215,10/20 11:19 AM,F3XN,1,0,0,0,1
962214,10/20 11:19 AM,F3XN,24,11,1,1,37
962213,10/20 11:18 AM,F3XN,18,11,0,0,29
962212,10/20 11:17 AM,F3XN,95,1,0,0,96
962211,10/20 11:17 AM,F3XN,0,2,0,0,2
962210,10/20 11:17 AM,F3XN,0,0,0,0,0
962209,10/20 11:15 AM,F3XN,0,0,0,0,0
962208,10/20 11:14 AM,F3XN,1,4,0,0,5
962207,10/20 11:14 AM,F3XN,189,212,0,0,401
962206,10/20 11:13 AM,F3XN,28,14,0,0,42
962205,10/20 11:13 AM,F3XN,0,0,0,0,0
962204,10/20 11:13 AM,F3XN,0,1,0,0,1
962203,10/20 11:12 AM,F3XN,29,9,0,0,38
962202,10/20 11:12 AM,F3XN,1525,113,0,0,1638
962201,10/20 11:11 AM,F6N,2,0,0,0,2
962200,10/20 11:11 AM,F3XN,0,0,0,3,3
962199,10/20 11:10 AM,F3XN,0,3,0,0,3
962198,10/20 11:10 AM,F3XN,1,4,0,23,28
962197,10/20 11:10 AM,F3XN,29,20,0,0,49
962196,10/20 11:09 AM,F3XN,100,2,0,0,102
962195,10/20 11:09 AM,F3XN,586,16,0,0,602
962194,10/20 10:46 AM,F5N,0,0,1,0,1
962193,10/20 11:07 AM,F3XN,5,13,0,0,18
962192,10/20 11:07 AM,F3XN,19,31,0,1,51
962191,10/20 11:06 AM,F3XN,375,34,0,0,409
962190,10/20 11:06 AM,F3XN,59,145,0,31,235
962189,10/20 11:05 AM,F3XN,3,2,0,2,7
962188,10/20 11:04 AM,F24N,0,0,4,0,4
962187,10/20 11:04 AM,F3XN,13,9,0,0,22
962186,10/20 11:03 AM,F3XA,6,10,0,2,18
962185,10/20 11:03 AM,F24A,0,0,20,0,20
962184,10/20 11:03 AM,F3XN,0,0,0,1,1
962183,10/20 11:03 AM,F3XN,236,116,0,0,352
962182,10/20 11:02 AM,F6N,2,0,0,0,2
962181,10/20 11:02 AM,F3XN,1,2,0,0,3
962180,10/20 11:02 AM,F24N,0,0,1,0,1
962179,10/20 11:02 AM,F3XN,0,1,0,0,1
962178,10/20 11:01 AM,F3XN,34,8,0,0,42
962177,10/20 11:01 AM,F3XN,235,33,0,0,268
962176,10/20 11:01 AM,F3XN,44,2,0,0,46
962175,10/20 11:01 AM,F3XN,117,2,0,0,119
962174,10/20 11:01 AM,F3XA,6,9,0,0,15
962173,10/20 11:01 AM,F6N,7,0,0,0,7
962172,10/20 10:59 AM,F3XN,0,0,0,0,0
962171,10/20 10:59 AM,F3XN,8,2,0,0,10
962170,10/20 10:59 AM,F3XN,437,101,0,0,538
962169,10/20 10:58 AM,F3XN,24,11,0,0,35
962168,10/20 10:58 AM,F3XN,0,2,0,0,2
962167,10/20 10:57 AM,F3XN,13,10,0,0,23
962166,10/20 10:56 AM,F3XN,0,0,0,0,0
962165,10/20 10:56 AM,F3XN,2,3,0,0,5
962164,10/20 10:55 AM,F3XN,159,24,0,0,183
962163,10/20 10:54 AM,F3XN,2,58,0,0,60
962162,10/20 10:53 AM,F3XN,0,2,0,0,2
962161,10/20 10:52 AM,F3XN,61,6,0,0,67
962160,10/20 10:52 AM,F3XN,0,16,0,0,16
962159,10/20 10:50 AM,F3XN,0,2,0,0,2
962158,10/20 10:50 AM,F3XN,114,1,0,0,115
962157,10/20 10:50 AM,F3XN,1703,166,0,137,2006
962156,10/20 10:50 AM,F3XN,2,9,0,5,16
962155,10/20 10:50 AM,F3XN,44,203,0,0,247
962154,10/20 10:49 AM,F3XN,216,35,4,12,267
962153,10/20 10:49 AM,F3XN,0,1,0,0,1
962152,10/20 10:48 AM,F3XN,32,8,0,0,40
962151,10/20 10:47 AM,F3XN,310,12,0,0,322
962150,10/20 10:46 AM,F3N,0,1,0,0,1
962149,10/20 10:45 AM,F3N,30,25,0,0,55
962148,10/20 10:45 AM,F6N,2,0,0,0,2
962147,10/20 10:45 AM,F3N,9,23,0,0,32
962146,10/20 10:45 AM,F3XN,64,5,0,0,69
962145,10/20 10:44 AM,F3XN,1,2,0,0,3
962144,10/20 10:44 AM,F3N,0,0,0,0,0
962143,10/20 10:44 AM,F3XN,35,22,0,0,57
962142,10/20 10:43 AM,F3XN,78,1,0,0,79
962141,10/20 10:43 AM,F3XN,11,3,0,0,14
962140,10/20 10:42 AM,F3XN,1263,31,0,0,1294
962138,10/20 10:40 AM,F3XN,32,1,0,0,33
962137,10/20 10:39 AM,F1N,0,0,0,0,0
962136,10/20 10:39 AM,F3N,6,0,0,4,10
962135,10/20 10:39 AM,F3XN,0,0,0,0,0
962134,10/20 10:38 AM,F3XN,0,18,0,0,18
962133,10/20 10:38 AM,F3XN,0,3,0,0,3
962132,10/20 10:38 AM,F6N,1,0,0,0,1
962131,10/20 10:37 AM,F3XN,0,0,0,0,0
962130,10/20 10:37 AM,F3XN,9,14,0,0,23
962129,10/20 10:36 AM,F24N,0,0,3,0,3
962128,10/20 10:34 AM,F3XN,64,2,0,0,66
962127,10/20 10:33 AM,F3XN,0,5,0,0,5
962126,10/20 10:33 AM,F3XN,141,57,0,1,199
962125,10/20 10:33 AM,F3N,5,18,0,24,47
962124,10/20 10:32 AM,F3XN,0,1,0,0,1
962123,10/20 10:32 AM,F3XN,13,89,0,70,172
962122,10/20 10:32 AM,F3XN,1,14,0,0,15
962121,10/20 10:31 AM,F3XN,1,2,0,0,3
962120,10/20 10:31 AM,F3XN,20,13,0,0,33
962119,10/20 10:31 AM,F3XN,1,0,0,0,1
962118,10/20 10:31 AM,F3XN,122,13,0,0,135
962117,10/20 10:30 AM,F3XN,9,3,0,0,12
962116,10/20 10:29 AM,F3XN,49,12,0,0,61
962115,10/20 10:28 AM,F3XN,46,1,0,0,47
962114,10/20 10:27 AM,F3XA,217,35,0,0,252
962113,10/20 10:26 AM,F3XN,0,1,0,0,1
962112,10/20 10:26 AM,F24N,0,0,4,0,4
962111,10/20 10:26 AM,F6N,2,0,0,0,2
962110,10/20 10:24 AM,F3XN,20,11,0,0,31
962109,10/20 10:23 AM,F3XN,6,2,0,0,8
962108,10/20 10:23 AM,F3XN,94,1,0,0,95
962107,10/20 10:22 AM,F3XN,83,6,0,0,89
962106,10/20 10:22 AM,F3A,174,67,0,3,244
962105,10/20 10:20 AM,F3XN,367,122,0,0,489
962104,10/20 10:19 AM,F3XN,0,1,0,0,1
962103,10/20 10:18 AM,F3XN,0,1,0,0,1
962102,10/20 10:17 AM,F3XN,555,40,0,0,595
962101,10/20 10:17 AM,F3XN,65,9,0,0,74
962100,10/20 10:17 AM,F3XN,3,3,0,0,6
962099,10/20 10:16 AM,F3XN,2,9,0,0,11
962098,10/20 10:16 AM,F3XN,320,88,0,0,408
962097,10/20 10:14 AM,F3XN,98,2,0,0,100
962096,10/20 10:14 AM,F24N,0,0,4,0,4
962095,10/20 10:13 AM,F3XN,3,47,0,1,51
962094,10/20 10:11 AM,F3XN,31,16,0,0,47
962093,10/20 10:11 AM,F6N,1,0,0,0,1
962092,10/20 10:10 AM,F3XN,25,1,0,0,26
962091,10/20 10:09 AM,F6N,1,0,0,0,1
962090,10/20 10:09 AM,F3XN,12,25,0,0,37
962089,10/20 10:08 AM,F3A,37,75,0,0,112
962088,10/20 10:06 AM,F3XN,13,15,0,0,28
962087,10/20 10:06 AM,F3XN,0,2,0,0,2
962086,10/20 10:06 AM,F3XN,31,1,0,0,32
962085,10/20 10:05 AM,F3XN,1,6,0,0,7
962084,10/20 10:04 AM,F3XN,1,0,0,0,1
962083,10/20 10:02 AM,F6N,1,0,0,0,1
962082,10/20 10:02 AM,F3XN,5,12,0,0,17
962081,10/20 10:01 AM,F3XN,8,4,0,0,12
962080,10/20 10:01 AM,F3XN,7,4,0,0,11
962079,10/20 09:59 AM,F3XN,16,0,0,0,16
962078,10/20 09:59 AM,F3XN,0,0,0,0,0
962077,10/20 09:58 AM,F3XN,0,1,0,0,1
962076,10/20 09:58 AM,F3XN,187,26,0,0,213
962075,10/20 09:56 AM,F3XN,21,6,0,1,28
962074,10/20 09:55 AM,F6N,1,0,0,0,1
962073,10/20 09:55 AM,F3XN,251,21,0,1,273
962072,10/20 09:55 AM,F3XN,0,23,0,0,23
962071,10/20 09:54 AM,F3XN,65,26,0,0,91
962070,10/20 09:53 AM,F3XN,56,6,0,0,62
962069,10/20 09:51 AM,F3XA,56,1,0,0,57
962068,10/20 09:51 AM,F6N,1,0,0,0,1
962067,10/20 09:50 AM,F3XN,0,1,0,0,1
962066,10/20 09:50 AM,F99,0,0,0,0,0
962065,10/20 09:50 AM,F3XN,11,19,0,0,30
962064,10/20 09:48 AM,F6N,1,0,0,0,1
962063,10/20 09:47 AM,F3XN,0,3,0,0,3
962062,10/20 09:46 AM,F6N,1,0,0,0,1
962061,10/20 09:46 AM,F3XN,15,9,0,0,24
962060,10/20 09:45 AM,F3XN,0,1,0,0,1
962059,10/20 09:44 AM,F3XN,0,15,0,1,16
962058,10/20 09:44 AM,F3XN,2,7,0,0,9
962057,10/20 09:44 AM,F3XN,4,4,0,0,8
962056,10/20 09:42 AM,F3XA,51,9,0,0,60
962055,10/20 09:41 AM,F3XN,0,0,0,0,0
962054,10/20 09:41 AM,F3XA,45,5,0,0,50
962053,10/20 09:41 AM,F3XN,4,24,0,0,28
962052,10/20 09:40 AM,F3XA,33,5,0,0,38
962051,10/20 09:39 AM,F3XA,31,3,0,0,34
962050,10/20 09:39 AM,F3XN,386,20,0,0,406
962049,10/20 09:35 AM,F3XA,0,0,124,52,176
962048,10/20 09:34 AM,F6N,3,0,0,0,3
962047,10/20 09:33 AM,F3XA,11,1,0,0,12
962046,10/20 09:32 AM,F3XN,26,2,0,0,28
962045,10/20 09:32 AM,F3XA,3,4,0,0,7
962044,10/20 09:30 AM,F3XN,301,11,0,0,312
962043,10/20 09:29 AM,F3XA,1,1,0,0,2
962042,10/20 09:28 AM,F3XA,140,2,0,0,142
962041,10/20 09:27 AM,F3XN,88,12,0,1,101
962040,10/20 09:27 AM,F3XN,25,0,0,0,25
962039,10/20 09:26 AM,F3XN,52,0,0,0,52
962038,10/20 09:23 AM,F3XN,49,31,0,0,80
962037,10/20 09:23 AM,F6N,5,0,0,0,5
962036,10/20 09:21 AM,F3XA,55,50,0,0,105
962035,10/20 09:21 AM,F3XN,0,1,0,0,1
962034,10/20 09:20 AM,F3XN,44,5,0,0,49
962033,10/20 09:18 AM,F3XN,397,43,0,0,440
962032,10/20 09:18 AM,F3XA,19,21,0,0,40
962031,10/20 09:16 AM,F3XN,122,25,0,0,147
962030,10/20 09:15 AM,F3XA,16,8,0,0,24
962029,10/20 09:14 AM,F3XN,0,2,0,0,2
962028,10/20 09:14 AM,F3XN,0,4,0,0,4
962027,10/20 09:13 AM,F3XN,1264,169,0,0,1433
962026,10/20 09:12 AM,F3XN,1,0,0,0,1
962025,10/20 09:09 AM,F3XN,43,4,0,0,47
962024,10/20 09:08 AM,F3XA,36,0,0,1,37
962023,10/20 09:06 AM,F3XN,9,1,0,0,10
962022,10/20 09:04 AM,F3XN,0,0,0,0,0
962021,10/20 09:03 AM,F3XN,197,202,0,0,399
962020,10/20 09:02 AM,F3XA,139,5,0,0,144
962019,10/20 09:02 AM,F3XN,3,0,0,0,3
962018,10/20 09:01 AM,F3XA,56,0,0,0,56
962017,10/20 09:00 AM,F3XA,57,2,0,0,59
962016,10/20 09:00 AM,F3XN,259,1,0,0,260
962015,10/20 08:59 AM,F3XA,58,1,0,0,59
962014,10/20 08:59 AM,F3XN,0,1,0,0,1
962013,10/20 08:57 AM,F3XN,0,4,0,0,4
962012,10/20 08:55 AM,F24N,0,0,1,0,1
962011,10/20 08:53 AM,F3XN,0,5,0,0,5
962010,10/20 08:53 AM,F3XN,0,1,0,0,1
962009,10/20 08:48 AM,F3XN,0,3,0,1,4
962008,10/20 08:46 AM,F3XN,0,133,0,4,137
962007,10/20 08:43 AM,F3XN,0,0,0,0,0
962006,10/20 08:42 AM,F6N,1,0,0,0,1
962005,10/20 08:37 AM,F3XN,0,0,0,0,0
962004,10/20 08:33 AM,F3N,7,11,0,6,24
962003,10/20 08:25 AM,F3XN,132,66,0,0,198
961980,10/20 08:06 AM,F3XN,131,34,0,0,165
961975,10/20 08:05 AM,F3XN,168,6,0,0,174
961967,10/20 08:04 AM,F24N,0,0,1,0,1
961960,10/20 07:54 AM,F3XN,1,5,0,0,6
961959,10/20 07:52 AM,F3XN,653,113,0,0,766
961958,10/20 07:51 AM,F3XN,67,6,0,0,73
961957,10/20 07:49 AM,F3XN,689,37,0,0,726
961956,10/20 07:48 AM,F3XN,2,8,0,0,10
961955,10/20 07:45 AM,F3XN,11,3,0,0,14
961954,10/20 07:42 AM,F3XN,0,1,0,0,1
961953,10/20 07:41 AM,F3XN,0,4,0,0,4
961952,10/20 07:38 AM,F3XN,0,0,0,0,0
961951,10/20 07:35 AM,F3XN,0,1,0,0,1
961950,10/20 07:32 AM,F3XN,1,0,0,0,1
961949,10/20 07:30 AM,F3XN,1,9,0,0,10
961948,10/20 07:21 AM,F3XN,1,1,0,0,2
961947,10/20 07:19 AM,F3XN,1,4,0,0,5
961946,10/20 07:16 AM,F3XN,0,1,0,0,1
961945,10/20 07:15 AM,F3XN,472,0,0,0,472
961944,10/20 07:13 AM,F3XN,4,7,0,0,11
961943,10/20 07:10 AM,F3XN,0,0,0,0,0
961942,10/20 07:10 AM,F6N,2,0,0,0,2
961941,10/20 07:10 AM,F3XN,42,25,0,0,67
961940,10/20 07:08 AM,F3XN,1,2,0,0,3
961939,10/20 07:05 AM,F3XN,0,3,0,0,3
961938,10/20 07:03 AM,F3XN,0,1,0,0,1
961937,10/20 07:01 AM,F6N,3,0,0,0,3
961936,10/20 07:00 AM,F3XN,0,0,0,0,0
961935,10/20 06:54 AM,F3XN,0,1,0,0,1
961934,10/20 06:49 AM,F3XN,3,1,0,0,4
961933,10/20 06:46 AM,F3XN,14,2,0,0,16
961932,10/20 06:43 AM,F6N,3,0,0,0,3
961931,10/20 06:39 AM,F6N,1,0,0,0,1
961930,10/20 06:35 AM,F6N,3,0,0,0,3
961929,10/20 06:26 AM,F6N,2,0,0,0,2
961928,10/20 06:22 AM,F6N,2,0,0,0,2
961927,10/20 06:16 AM,F6N,3,0,0,0,3
961926,10/20 06:04 AM,F3XN,103,33,0,0,136
961925,10/20 04:53 AM,F3XN,659,85,0,0,744
961924,10/20 03:58 AM,F3XN,0,0,0,0,0
961923,10/20 03:56 AM,F3XN,0,0,0,0,0
961922,10/20 03:37 AM,F3XA,70,205,0,173,448
961921,10/20 02:43 AM,F3A,223,99,0,1,323
961920,10/20 02:11 AM,F6N,1,0,0,0,1
961919,10/20 01:48 AM,F3XN,0,1,2,13,16
961918,10/20 01:37 AM,F3XN,76,64,0,1,141
961917,10/20 12:24 AM,F6N,1,0,0,0,1
